text	label
dan gidan obasanjo ya sha alwashin yi wa buhari yakin neman zaben 2019	positive
me yiyuwa amma ku tsaya kupahimchi maganarta	neutral
kwana daya barawo ke kwasheta	negative
ngrpresident mbuhari see how baba is looking fresh and healthy ready to take nigeria to the promise land	positive
my bro wan die dan bakinciki	negative
happy birthday   shekaru masu albarkah 	positive
kowa dan izala yayi raayinsa nima nayi nawa shine amsar	negative
allah ya tabbatar da mafi alkairi 	positive
anhaifi manzon allah saw a garin makkah ranar litinin 12 ga watan rabiul auwwal a shekarar giwaye sallallahu alaihi wasallama 	neutral
hmmmm  to sugano yan uwan su da corona ta kashe koko su gano was	neutral
ki gaba da gashinki yan mata jahannama akwai enough space ba wadda zaki tare wa fili is possible ma a baki long time ki dade kina shanawanki kafin ki wuce can 	negative
gaskiya gwamnati elrufai bata adalci wannan ya nuna cewa zaayi sonkai 	negative
to allah ya zaɓa wa alummar zamfara nagari	positive
allah yasan bamusan kowa sai baba buhari	positive
wai ina masarautar gaya imagine na tafi kallon hawan sallah gaya this is not me muna allah wadai da wannan tsari	negative
ya allah muna rokon ka ka bamu zaman lafiya a duniya baki daya 	positive
allah ka tsare mu da zuriarmu kamana maganin damuwanmu duniya da lahira	positive
bwamajin turanci kumana da hausa 	neutral
yes hkn malam aminu so zamu hada karfi da karfe da kuma rokon allah ya kawo mana karshen boko haram banditry corruption in  jamaa gaaa zabe n 2023 yana tunkaro mu mu kula da kanmu da laafiyar gudun kar ayi amfani da kuriun mu wajen zaben azzalumin shugaban	positive
wannan abun yamin ciwo sosai 	negative
har da baba	neutral
wai shia tafi sunnah lallai ka koma karatu kuma kamaida hankali nonsense	negative
i refuse to be confused ya baka hada nakaba kana mana hasashen 2030kanada tabbacin kana da rai	neutral
allah yatsare mana imaninmu 	positive
nikam yaushe zakiyi aure ne kinga yanxu december zaki ciki 27 years almost to 30 idan har kyau naki ya fara fading toh gaskiya las las giveaway zaayi 	neutral
katsina funtua lg har kyauta ake bayarwa	positive
wai wane twitan dai tukuna	neutral
cant wait kudu da arewa taka ce 	positive
kaiii allah ya sauwake yayi ne dan ya bakantawa mutane ya hanaku zuwa kasuwa ya bude gidan kallo amma ba mamaki ko kudi suka bashi 	negative
who will you vote as the next president of nigeria 2019  vote between baba atiku and baba buhari mbuhari	neutral
shifa jahilin bahaushe ya dauka su kadaine masu addini shifa yanayin saka kaya aladace ba addini ba toh idan ba hakaba ina zakukai turawa da larabawa da sauran kasashe ya yarirrika	negative
just like chief mko abiola was robbed of his mandate in on june 12 1993 by enemies of democracy wahala de for this country	negative
ki samu kiye koh keh ma zaki samu sauki 	neutral
allah dai ya kara tsinewa israilawa makiya allah allah kwashe musu albarka tsinannu 	negative
beware of scammers  baba atiku is not disbursing free money  you should not reveal your sensitive details	neutral
mun so dai a ce shi ya zama shugaban ƙasa a 2023 duk da ba komai nasa muka yi ittifaƙi a kai ba amma tunda ya fi ganin a mayar kudu don su ɗana to sai dai mu ce allah ya zaɓa mana wanda yafi alheri 	positive
the fact that people now prefer him to buhari shows how much baba has failed us	negative
ni wlh duk ba wannan ne ke damu na ba abinda ke damu na shine yanda ko wani bayan mintina ake tafiya talla idan ana nuna film din labari na mallam babu yadda zaayi a rage yawan tallan nan ne	neutral
my benue people if the augument is ethnic and religious don’t vote for baba buhari or atiku	negative
saina nunamawa director wannan tweet nakan mutumin banza kawae 	negative
ni har yanzu ban ta6a rokon allah ya kare ni da ga corona ba tsabagen ban gama daukarta siriyos ba	neutral
i stand with baba	positive
kut 10k wallahi ni ko kyauta bazan zauna na kalleta ba kuma mgn charity to help poor muma muna dasu a unguwan mu ba sai na bayar ta hannun ta ba shashanci kawai	negative
shima wannan taron sunnah ne	positive
wannan kam tofa 	neutral
gaskiya ne major 	positive
2018 proposed budget  presented  approved  signed  presented by ngrpresident  our own baba n8 61 trillion  nov 7  2017	neutral
baba buhari called the late hauwa limans father  mohammed  and icrc president pmaurericrc on tuesday	neutral
sai baba sai next level show your face next level	positive
wannan gaskia ne baba bamu gani ba koma koda wasa bamuji labari ba jamu muje jagoran talakawa next level muna ciki warhaka	positive
dama nayi tinanin haka zai faru dashi sabida ya matsa hanu dayawa	neutral
wow  gaskiya wallahi wanan wakar tayi dade so ssai 	positive
ai kullum cikin fadan hakan yake sai jiya ma naji abakin wani tsoho a maida jonathan amma aja masa kunne inji wani tsoho da yaje sayen masara 	neutral
wlh sai allah yasa anci ubanshi wanan mc wayyo cikina	negative
zamu kalla a waya	neutral
masha allah you impressed me since you realized your mistake and regretted with apologized allah yabamu irin xuciyarki	positive
wlh harga allah ina matukar kaunarki har cikin zuciyataamma kash kinfi karfina wlhdomin kuwa ko pure water bazaki iya aikena siye ba  amma dan girman allah kisakani a cikin jerin kasoyanki 	positive
allah ya bayyana su duk wanda ya tsinta dan allah yakai gidan radio	positive
ga sanyi ga kida ga rake duk a lokaci guda gaskiya yau an sha dadi	positive
toh mu ai allah kadai xece mu yadda dashi mun babu wani inba shi ba	neutral
ya yi daidai bai fadi karyaba sabi da ronaldo yakai dan kollon da zaa koyi 	positive
alhmdllh su anragemasu wahalan shan sanyima xasuhuta avunsu lolz 	positive
aslm inagaisuwa rahama  yakike ya gida	positive
gaskiya kin burge ni sosai wallahi kin nuna wa duniya ke cikakkiyar musulma ce god bless you dear	positive
wa ze dauki maganar dan giya seriously	negative
uhmm kuyi duk yanda kukeso allah bamu kudin saya	positive
da kyau fasihin director 	positive
munafiki karya yake wlh 	negative
an kuma  wlh ya kamata a soke karota a kano basuda wani anfani kudin jamaa kawai suke hadawa	negative
kin ganki lumi lumi abunki tsaddo baki tsufa sai dai kiyi girgiza ki chanza sabun gashi 	positive
will it not be better for baba  to focus on what your achievements have been than why you should be re elected	neutral
addaurayie da bakatsine 	neutral
dodar ma dodar ku bamu kidan general a sama	positive
toh me zasu jira 	neutral
ya zakiyi dressing colour din motarshi are u crushing	positive
ana iya hege a kasarmu	negative
dama nan ne bangon duniyan 	neutral
ƙarya ta ƙare tusa ta ƙarewa bodari  daman ai duk karyar banza ce	negative
kun iya bada labarin mutuwa kam nonsense 	negative
amana sai dan amana wlh ubangiji allah ya dawo mana da jagora	positive
raban tqliyq duk sati da akebawa talakawa dan suna mugun kareta da taliyar nan 	neutral
sbd sun hadu da manya	neutral
allah ubangiji ya gafarta masa yasa ya huta ya baiwa iyalansa hakurin rashin sa idan tamu tazo muyi kyakykyawar makoma rayuwa babu tabbas 	positive
allah ya kawar muna da wannan balai ameen 	positive
tohhh mudai munga gawar mutum43 a qasa kuma muna fata ubangiji allah yayi masu rahama yasa aljannah firdausi ce makomarsu muna roqon allah ya kawo mana sauqi acikin shaanin tsaro yazaunar da qasar mu lpy ameeen	positive
oh god have you seen nigeria presidential debate that is ongoing please tune and watch our 2 baba	neutral
in kura na maganin zawooo taiwa kanta me na sama ya samu ballantana dan jefomin ayi dai mu gani in tusa zata hura wuta	negative
bakomai oga saboda kaine amma on one conditon oga direkta 	neutral
lukman ya cika namiji  ga hakuri ga class ga sanin ya kamata kuma beda wulakanci da zuciyan nan na fada	positive
karyar banza zaku cuci mutane daita yaya akaci wanna bashin bayan du wata kowa she ya biya ko ayake masa wutar wani watan ma said 2 ko sau 3 zaku bada watar amma sai mun biya kudi daidai gaskiya kedco kun so cuta dai kawai naira billion 175	negative
my gov ve said ita rashin kira karen bebe ya bata	neutral
kinje neman follow back wajen neymer ne baki samu ganinsu ba sai suka hadaki da me kula da ciyawar stadium kamar yanda idan anso a ganki kike feeling ke cele ce to kema kinje wajen masu gidanki sai kin jira 	negative
bama dole gyada tayi mai ba ll	neutral
 mun zama kuraye	neutral
just for you real anty  wallahi babu wanda takai rahama wanka a twitter support 100	positive
sakon barka da yau da fatan alkhairi ga kowa daga mystery super star  maryam kk	positive
baku biya ta katanga kuke haurawa thats why	negative
taska maaruf zaka fara yankan kai koh	neutral
aiki dai ɗan ubanshi dambu sai yaji mai 	negative
allah ya gyara mana kasar mu	positive
innalillahi wainna ilaihi rajiun kaii sai kace shirin fim kullum satar mutane kamar satar kiyashi  allah kayi mana maganin wannan masifa	negative
garin yaya ko dama dan neman baya ne 	neutral
ahap a haka gayyar zata watse 	neutral
wallahi kin ja mana i was speechless wen i saw it alokacin kawai naji wani irin wallahi i felt bad	negative
ko a runfar zabe na fadar shugaban kasa sai atiku ya kada buhari cewar tsohon jigo a apc	negative
if nigeria were to be your private business  who among the following will you employ as the manager  alhaji atiku  or baba	neutral
chief moshood kashimawo olawale abiola  cfr  24 august 1937 7 july 1998  was a nigerian yoruba businessman and publisher siyasar bana	neutral
thats why i like u so much bazan futar da rai ba watarana zamu hadu face to face in sha allahu	positive
shi jaki sunan shi kaji koda kuwa jakin sarki ne	negative
yaukam sai hankali mu yan abuja fah zaayi bada mu kenan may be i need to come over for a weekend sister been offline for a week i miss alot	neutral
abun sai yai kyau kamar nono da fura	positive
yan iska kawai kubar shiar mana tunda ba dole bace	negative
allah yasaka ma mal nasiru da alkhairi	positive
wannan sune suke kara karya farashin mu wannan ai bada kaine kawai sai kace kyauta zata aureshi 	negative
allah yashiga tsakanin nagari da mugu allah yasa mufi karfin zuciyarmu ameen 	positive
ai har kan anciye bama hanci kawai ba	neutral
kudinmu na ajakuta power plant	neutral
tinda idan kayi aljannah zamu shiga ba  dan masu waka shege mummuna kawai allah ya debema daidai gwargwado  tayimin zafi be	negative
idan mutum zaibaka riga saika fara duban ta jikinsa 	neutral
bahaushe yache tsuntsun daya ja ruwa shi ruwa kan doka in banda asara irin taku a matsayinku na yayan musulmai hausawa ache wai mace baliga tazo gaban wani da namiji tayi tsirara innalillahi  wai a haka kuke claiming wai tarbiya kuke bayarwa ga irin tanan munga irin tarbiyar	negative
gaskiya hakan dai yafi sabo da jama ar kano susan mastayisu	positive
allah ya sani gaskia labarina na this week ya bata min rai saboda banso lukman ya janyen soyayyarsa ba ga surayya anbar mahmud shi kadai kma dama ackin dinsa ba birgeni yake ba domin y cika xafin rai da yawan kishi to yanzu babban yayan mu ya za ai kenan saira	negative
pmb is purely direct  bai iya munafunci ba  part of the reasons why i support the man	positive
aunty sadau just tank god say na lagos if na arewa u they drive and mistakenly enter goslow in minutes zaki ji bakia nan yaran malam sun sace ki the next thing u go hear is buhari yayi alawadai da abin da ya faru finishgod save our country 	positive
kanku akejimahaukata sun fada rijiya	negative
she fa kyauta ba lalle kinyi sauraye ko miji mai kudi ba wallahi abin ajini yake	neutral
allah ya kara miki kaunan shi da ikon kulawa dashi har allah ya rabaku lfya mukuma allah ya jikan namu baban 	positive
mai murabus kenan	neutral
𝐀𝐦𝐞𝐧𝐧 𝐚𝐥𝐥𝐚𝐡 𝐲𝐚 𝐤𝐢𝐲𝐚𝐲𝐞 𝐧𝐚 𝐤𝐚𝐛𝐚	positive
duk uban bashin da ake binsu	negative
wai dama hka kika kara kyai na kwana biyi ban ganki ba 	positive
toh sannun ku da kokari 	positive
ina maganar noma babu tsaro	negative
manya kasa basa kaunarka baba to kaima zarginda talakawa sukeyimaka kenan masu kukan abinci haryau har gobe allah sarki 	negative
ya ball din ba iska 	negative
what a tears allah ya axurtamu da irin wannan alkhairin	positive
wayyo cikina  laugh clinic got me	neutral
ina mai roka miki gafara awajan ubangiji allah ya yafe miki allah yakiyeye gaba  muna tare dake	positive
zai ci uwarsa koma waye ke handling handle en lahira ai ba hausa ake ba tunda ko addua babu 	negative
wannan shi ne a da keka a hana ka kuka	neutral
meyasa amurka basu son duniya ta zauna lafiyane	negative
allah sarki ku bamu address koda na mutum 2 ne muje muyi wa ahalin su gaisuwa	positive
innalillahi wainna ilaihi rajiun  ubangiji allah ya yay muna maganin wadannan matsaloli 	positive
allah yatoni asirin su 	positive
intenet a masallachi wani salo ne na karkatar da masu ibada zuwa wani abu daban amma a raayina bai da mahimmanchi	neutral
lallai kam abun akwai rikitarwa amma sir ai kafi kowa sanimudae yan kallan ne kawai 	neutral
who won last last nights debate mai karya ko wanda zai karya	negative
bashirahmaad  all for pmb  5000 foot soldiers for baba buhari in lagos  pmbx2	positive
kutumelesiwlh ina ruwa yau rayuwata ta koma kamar kalalaba	negative
yey  in rariya mood  tgis	neutral
allahumma ajirni fi musifatiallah katsaremu ka karemu baki daya	positive
kundin tsarin son zuciyarka dai	negative
matasan kutare ko km matasa masu lfy	neutral
nabi buhari da gudu 	negative
akwai azumi fa gobe dan haka ki dau samara 	neutral
shege dan kazama 	negative
yayikyau up baba buhari	positive
ni yadinka neh ma yamin kyau darekta	positive
allah yayafe mana gaba daya mal musa	positive
ramu wannan dogon karan hancin naki har zai karye ai  looking stunning tho 	positive
see this guy a najeriyar ma baa gama sanin ka ba kana maganar duniya kasan girman duniya kuwa pls karkasake mana irin maganar shirmen nan 	negative
never lose hope sai mun yi kacakaca da moenchengladbach ma tukunna	neutral
amiin sm amiin amma mallan yaushe zamu dawo kallon shirin nan mai kayatarwa wato labari na	positive
innalillahi waina ilaihim rajiu  karka damu sarkin wanka wllh allah yana tare da kai kuma duk wannan abu da sukeyi wllh allah lokacine in har da rai na da lpy dole suganmu kuma su rabuda mu ai allah baya zalince wllh  kuma wllh sai allah yayi mn sakai ya	positive
komai dea akan talaka yake karewa 	negative
dai da hanunsa da kafarsa ras ha  ha	neutral
pdp officialpdpnig presidential hopeful  atiku vanquishes ngrpresident  baba buhari mbuhari in popular pro buhari blogger  omojuwa	neutral
babban yaya ansha kyau	positive
 shi kuwa trump me yayi zafi hk	neutral
taya kasan haka lallai ta tabbata kana da alaqa da masu assasa taaddanci a qasar nan ya kamata a sauke kuma a kamaka a hukunta ka ko kuma fadi dalilin da yasa kafadi wannan maganar wannan ya nuna cewa bakama san aikin ka va	negative
baba buhaari dodar	positive
tohh majalisar dinkin duniya	neutral
innallahaazza wa jallah lallai allah mai girma da daukaka yuubalittaubatal abdhi yana amsa tuban bawa malam yugaggirr matukar baikai gargara bah uban gijin daya haliccemu kenan fah balle muh guda manni jini da tsoka kuma masu sabo yakamata mu duba mu yafe mata 	positive
shi buharin yafi qarfin zuwa dakansa kenanissoryt sha	neutral
darling kinsha kyeu over 	positive
kutmelesi  kaji haukan technology ko	negative
abashi balance dinshi indai shima ba return ya karba b	neutral
rahama sadau manya 	positive
ameen summah ameen  allah ya gafarta mishi yayi mishi rahma allah yasa yahuta	positive
yo yan twitter ma har wasu shegu ne  sun dade babu mutu ba  	negative
eyya sorry dan atiku shine mijin dazata aura shiyasa 	neutral
bakomai nidai duk wanda ya zalince ni shida allah ban yafe masa bah  don ni maraya ne wlh	negative
bashikadai ba  aka fitar daga wasan ba	neutral
ina mika sakon gaisuwa agareka sarki bisa rashi da akayi maka na mahaifinka allah ya baku hakurin rashi	positive
da alama kuraye sun fara yiwa malam yawa 	neutral
day 4 set  bayero university kano	neutral
ina matukar girmamaki har sai da na koma kiranki da aunty rahma na sha suka da zagi a kan kare martabarki amma hakan bai sai kin ji tausayina ba duk da cewa ba a shiga tsakanin allah da bawan shi meye wannan yanzu	positive
nifa wurin babar taka ta gold ce ya tashi kaina  i just like that guy 	neutral
kasarmu nigeria na neman tarwatsewa fa ayi agaji don allah  mr president theres a need to take any action possible please	positive
mamar zaa bude ita zumar tayita harbi kenan 	neutral
ai yanzu corona yabi jiki  kowama yabar social distance	neutral
suna unfollow ne wlhy same people are faking zasu bika and then suzo su guje ma kuma 	negative
abubuwan da zakayiwa mace ya kara sonka taji batasan kowaw saikai karanta su a nan 	neutral
amma dai azumin nan bai ta6a ki ba meye sirrin ne 	positive
a banza vpn dey	negative
sarki ka taimaki dan uwanka saminu shuaibu 7123157016 fcmb	neutral
allah yamasa albarkar yaburgeni sosae allahu yabashi lfy kuma 	positive
ameen thumm ameen darajjar manzon rahama	positive
kuji tsoron allah 	positive
ai dole ya yaba musu	neutral
yaje gaida uwarku bakusan ma me kuke fadaba wallahi mutanen kano suna san mutum irin kwankwaso 	negative
unfortunately the apc or pdp will produce the next president of nigeria ya allah see the masses through	negative
malam aminu ba haka ya kamata kace masa ba tunda har yana kallon series firm naka ai is one of ur fans just kace masa to tunda ai to bata karya wuya malam aminu shawarace	positive
ina ruwanmu daman bazamu ba  wancan shhekaran ma da muka je 200 ya bamu dan uwatar 	negative
this is how it should be actually allah ya tabbatar da alkahiri kuma boye boyen ku out of the blue muga sanarwar daurin aure 	positive
sarki bread me yanka yanka tsarabata	neutral
nawa zaa ba ncdc da allah dan kada ta munana	neutral
da mai shan wiwi tabasigari shisha duka daya na dauke su saboda hayaki suke fitar wain bakauyanchi ba mai zai sa wata sakarya shiga tana busan shisha har ta kusa tayar da gobara 	negative
ranka yadade ya batun giveaway ne azumi fah yayi nisa show some pls	neutral
wuta bal bal   	negative
allah ya taimakemu dan allah a taimaka wa ummata dan girman allah tana kwance asibiti babu kudin treatment 	positive
while baba tapped into a yearning to end years of corruption   abubakar   71   is capitalizing on the angst of the elite	negative
adam a zango ya cancanti yabo 2fingers 	positive
may allah bless you allah yacika miki burinki kema	positive
awwwn rahama stay safe dear	positive
i am going to stay on this case till guinnessngr come clean like firstbankngr did following the visit of baba buhari mbuhari to lagos	negative
yawale mayen jirgi ina jiye ma bawan allah nan kar garin yawan shi a sama yayiatoh	negative
hukumar inec ta sa maikatan tsaro a koina is better that way	positive
gskyn se anayi ana dan shan iska	neutral
bbc why you say this secret out wallahi zakusa jaruma duk tasa kukan ma yayi tsada like goron tula  tab kuka takusa tafi karfin talaka kenan in kuka bari taga post innan kuka rip 	negative
king musamman mah ace aunty maimuna ne mah tayi bah your answer is miyan agusii	positive
im disappointed in nigeria its 2019 we still act like animals on election day wawaye kawai	negative
gaskiya palastine tana bukatan adduan dukkan wani musulmin duniya	positive
allah ya taimaku sarki 	positive
duk shirye shiryen daurin auren ne	neutral
mahaifiyata itace uwa ta gari da ta bani tarbiya na gari wanda a ko yaushe nake alfahari da ita allah ya jaddada rahma a kushewarki amin 	positive
naganka director tsaf kana latsa jawwala	neutral
haba ae son banxan sai yyi maka yawa gaskiya nikn harga allah nafison hidima erin na laila sumayya ta kara gaba kawai akwai kasuwa	neutral
ni so nake ma a daina shigo da atampa da yadi gaba daya kowa ya koma sa gaskiya textile na tina wata waka buhari a dafa su ganduje a soya su afi ragargazar bangaren arewa basaji a arewanna afi ragargazar hausa wa sunfi iskanci	negative
during the pdp campaign in kano you hired people from niger and chad to deceive atiku all to collect his money toh wallahi better return his money	negative
baba eminently qualified to contest 2019 presidential election allah ya taimaka	positive
kowa yace zai baka riga kalla wadda take jikinsa ana biki a gidansu kare yace banga komai aqasaba 	neutral
scam scam scam   this government na scam ooo   baba na yahoo boy	negative
wallahi wasu lokutan a nigeria kowayan mutum baya cika balinta na a ce ankera mota mai amfa na da wuta 	negative
alwala ce kawai baza muyi ba my boss lady  congratulations maltina ambassador 	positive
sai canada za mu zo mu sha wiwi 	negative
yanxu abunda yarage kudin budget ba state ma a fara karbu su kawai 	neutral
 allah ya kawo muna karshen wannan balai	positive
allah ya biya mai gida	positive
anjima ana rena mana wayo a kasarnan 	negative
allah ya yafe musu baki daya	positive
aii gani gareki yan mata ni ina rokanki yan mata so bani inn baki din ina kyaunarki	positive
wanna abu din muna bawa kammu wahala ne amma kutina allah ya turo mana da shugabamu annabi mu dan haka kowa ya koma qurani koh hadisi amma wanna maganganu ba naku bane shi musulmi komi nashi yana yinsa ne da koyar war addini musulin ci allah kah ganar damu baki daya 	positive
kyauta zasu raba data ne 	neutral
sawa doki yadinnan mai tsada wato banbalasta da kuma yawo da motoci na alfarma wadanda akasa musu number plate jarma 1 and above kuma mutunne mai kishin yankinsa yakai mutane bila irga aikin hajji fatanmu allah yagafarta masa	positive
i hope the broadcasting organisation of nigeria team that organised the vp convened covenant christian centre are not babas party	negative
bayern munich inshaallah zasuyi winning 	positive
kai ana hegiya a afrikar mu wallahi kaga yanzu ba sauran gasar kwallon kafa a nahiyar afrika kenan daman wancan karon kyar aka samu masar din suka dauki nauyi gasar	negative
hasbunallahu waniimal wakil allah kayi mna tsari ga wannan cutar 	positive
wasikar masoya dauke da zafafan kalaman soyayya masu ratsa zuciya karanta su a nan 	neutral
amin summa amin yan mata 	positive
tab babu zuwa shakatawa kenan wasu musamman jihar da take gefen hannun hagu	neutral
gaskiya ne oga allah yakara basira 	positive
it will leave baba atikus fans scarmbling to find an explanation for this dismal performance at the end of it	negative
the choice of moderator of the vp debate is a bang on point gaskiya	positive
allah ka taremu saboda annabi 	positive
 my study area ba lantarki 	neutral
this is awesome  allah ya qara basira	positive
fan dinki ma sunfi haka kawai akwai wa enda basuda smart phone ne shiyasa amma ke ai kin wuce nan kai bari nace miki ma i love u wallahi by dixssaric to little pretty young lady taking on the drivers  mrs	positive
awwwn soo touching  allah yadada buda miki ya kuma karekii	positive
shawarata ga baba shine dan allah a duba talakan nigeria musamman yan arewa wallahi ana cikin mawuyacin hali yanzu sai kaga magidanci ya koma almajiri sbd kawai bashi da abin yi km ga iyaliyara kanana suna bin gidaje suna barar abin da zasu saka a bakinsu	negative
yace masa mai 	neutral
masha allh munanan xuwa 	positive
hmm indai azumine saikinyi mai tsoron azumi kawai	neutral
this is a lie from the pit of hell     ffk reacts to president buhari  s claim that nigerian soldiers were soft on biafrans kanku ake ji	negative
wai nan bbchausa amma ko rubutun hausa basu iya ba mtsww kaji fa wai halaka 	negative
after all wetin concern me with family affairs mbuhari and apc are one family abi	neutral
daddy alinuhu or what are there calling you ana baku amana yara kuna barin su suna blue film dadin abun dai kai ma ka haifi mace 	negative
ga talakawa a cikin halin haulai amma an kaiwa kaji abinci wait wai suma kajin ko ka manta su kansu abinci ne	negative
kalli bidiyon yanda zaka gane duk wasu abubuwa da budurwar ka takeyi a waya batare da ta saniba 	neutral
mu munce 29 zaayi musu mari ko kuma asa chacha 	neutral
akwai allah ai	neutral
kuyi mashi wani abu na cutarwa kugani za kuga yadda ake zangazangar rashin kunya matasa maza da mata zamufito a jihar katsina abinda baa taba ganiba zaku ganshiiskancin banza	negative
ai shiyasa naga shi kansa dan rainin wayon yana zama a qasar tasa ana dubashi may be fa a jordan din dayace yayi wannan kalaman tunda yasaba qanqantar damu a idon duniya	negative
if voting baba in 2015 is a mistakei will deliberately repeat same mistake	positive
babban yadda zakayi yaki da shutan maleria shine ka tabbata cewa ka kwanta cikin gidan tsoro 	neutral
wow amma zulum ya birgeni yasin	positive
wai me ke damuwar bbc hausa kwanan nan who is managing this account please	negative
allah sarki talakan kasata nigeria wllh yakamata kasan mekakeabin da yashafeka daban abinda suke rigima akanshi daban allah kabamu masu sanmu da amana amin 	positive
 toh zan iya siyansa $10000	neutral
to taya zaku sami damar yada labarin alokacin tunda wakilan dazasu baku rahoton har dasu acikin nigeria ake fadin alkairi koda yaushe	neutral
ka manta hular ka a motar laila  ko taka ce zfin rabuwa yasa ka manta hular	neutral
ina fatan shima xaa gaggauta aikashi lahira dan iska dan asara ina amfanin haihuwar wannan 	negative
kada a raina mana hankali mana ake nuna mana wadan da suka kamu din yanda akeyi a qasashen waje man dis is madness 	negative
abun dama har gidan yaari ya shigaa	neutral
instead of a dauko su a gyara su sojojin suyi amfani dasu yafi ace dai konasu akayi dan most of the vehicles na yan ta addan a wurin sojojin suka qawcesu 	neutral
wa yaga danka a kujerar gwamna 	neutral
this is twitterkomai da ruwan ka 	neutral
ga talakawa a cikin halin haulai amma an kaiwa kaji abinci wait wai suma kajin ko ka manta su kansu abinci ne	negative
oga hanyar kano part two kenan 	neutral
wai sai kingama fitarda kudinki a cinema sannan mu talakawa zamu kalla	neutral
cutar korona hana kowa aiki 	negative
maganar vaccine de munyi rejecting 	neutral
ashe kuma kun gaji kenan 	negative
atiku ya yi gargadi a kan rugujewar najeriya ku mene ne raayinku 	neutral
kuma ba barawo dollars bane	positive
alhamdulilah  allah ka karawa annabi daraja buhari 2019 	positive
muje zuwa shege ka fasa 	negative
allah sarki allah ya biya kah damuna dah irnka ah nigeria dah mun huta wasu sai su kashe billions of naira akan ya yan su 	positive
 ke kuma kina ina	neutral
innalillahi wa inna ilaihi rajiun rahama kiji tsoron allah swt ki dena sanya irin wadannan pictures a kafafen sadarwa a matsayinki na musulma ki tuna da mutuwa kuma sam ba alkhairi akan tsinuwarda alumma ke maki	positive
mu kuma miliyoyin dalibai na nan suna gararan ba saman titi you refuse to do something at long last	neutral
hmh  ayi dai mu ga mu kan talakawa yan kallo ne	neutral
alhaji dankwambo during pdp presidential primaries when he was selling his ideas to nigerians	positive
daman yayi farko ai dole yayi karshe 	neutral
may allah protect us ya jikan musulmi	positive
bayajidda da sarauniya daurama da gidirgidir 	neutral
ah su rahama za axha madara sa lemu fah mudai deja mn muna tchikin sa alhmdllh allah ya karbi ibadumu yakuma yafe mana kurakurai ameen barka da charuwa 	positive
ba kuka kayi ba ko amai zaka yi qwalelenka nijeriya sai baba	negative
dama basu d aiki wadan nan inyamuran sai danfara da safarar kwayoyi don haka suka lalata sunan nigeria a kasashen duniya sbd haka visa ta china  da sauran minyan kasashen duniya takeyi mana yan nigeria wahala matuka sbd wannan mummunar hali nasu  dama raba kasar akayi wlh	negative
why are you guys tagging me  can koma addinin nan	neutral
tabbas nigeria bazata taba zama daya ba indai haka na faruwa kuma baa daukan mataki a kan su wallahi bazamu yarda ba yoroba people stop kill our people enough is enough	negative
allahumma innaka afuwwun tuhibbul afwa fa afuannaa 	positive
ba iya kalaman ba ma kadai hatta shi kanshi 	neutral
hmm amma rukayyah ta birgeni kwarai da gaske domin ba don ita ba da allah kadai yasan gararin da sumayya zata samu kanta a hannun talaka mai girman kai da kishin tsiya lukman is the answer in world of lovers and he is a love solving person	positive
hhhh  ta ce fa ita ba shashasha bace but ni kam waye ya fadama maman sumayya akwai wuka a jikinta hmmsai a episode 3 zamu gane hakan	neutral
karshen ta da eyakah	neutral
wuta direct   allah ya kare mu	positive
lmao wai maman mawakiya 	neutral
zamani mara aure su keba masu aure shawara	neutral
shima da quriu miliyan biyu da dugo tara 29million ya lashé zaben 	neutral
this is not proper at all instead ku che ayi mai adduaa shine kuke tambayan wani film dinshi aka fi so tchewwwww too bad	negative
allah yasa muna cikin masu kai karshen 2021 itama 	positive
toh ai gamu a cikin twitter din ko dai a facebook ne nake 	neutral
ya mutu yana kafiri 	negative
matsalar itace koda an kwato kudaden wasu ne ke sake sacewaanyi ba a yi ba kenan	negative
mu agurinmu badan wahala bane nigeria se baba two terms	positive
munji dadin wannan labari muda a cikinta allah ya shiryar da su 	positive
toh allah mudai bayinka ne kuma talakawa ne mu sannan gwauro neni ko auran fari banyi ba idan suka kwaso balain su allah ka sauke musu su kadai firaunan da tin farkon rayuwar sa har mutuwar sa balai ne shine wai zaa tono salon su batawa allah rai ya ci uban mutane	negative
daga baya kenan akwai alhinin da ya huce ka raka mamaci zuwa makwancin sa allah ya jikan sojojin mu musulmai da suka rasa rayukan su	positive
wannan aii ba dukkansu bane en nigeria  wasu a ciki en niger  ne	neutral
at the whole africakai ina tayata murna wallahallah ya qara basira	positive
qarya kike munapukar annabi isah wlh ki tanadi kalmomin da zaki kare kanki a gaban allah atoh ubangiji zaka taba kowa ya kyaleka amma banda annabin rahma ta silar ki anzagar mana abu magi soyuwa a wajen mu allah ya isah bamu yafe ba wqi shin hoton da kikai koyrwa addini ne 	negative
nifa yau malam aminu ka gama min komai wllh danni yau bani da lfy amman ina kallon series din yau sai naji na warke ubangiji allah ya kara million of basira trillions of yar dar allah billions of masoya allah kauda idan makiya mahassada ameen ya allah  up upon up aminu sai	positive
 he usually use to say engineer ya streaming kuwa nace yallabai yana yana tapia dai dai allah ya sa ka aljanna	positive
bai kamata ku maimaita mana wannan katobarar ba	negative
allah yay masa rahama yabada gudunmawa wajen bawa alummar annabi nishadi	positive
sadakin so inci kudina	neutral
allah ya isar mana ya allah duk me hannu acikin kashe musulmi da bata sunan musulunci allah ka tona asirin su ka wulakanta tasu kayi mana maganinsu ya allah 	positive
tab yayi mgn shiya taba 	neutral
ana ji amfani da shi ne baa yi 	neutral
karasa wake rubuta mai abun nan wani abun dakajishi sai kai mamakin wai anya kuwa anyi bincike kan fadin shi	neutral
gaskiya sirin yau yamin dadi saboda sarkin waka 	positive
 imagine yanzu allah mukabarwa zabi ba kubah	neutral
lala kuka lala na hangota nacce ulala  crush everyday ki huta sarauniyar mataa	positive
thank you apc insha allah sai kunkai labari	positive
ku km en kwakwaf sai d kuka gano	neutral
kai sadau balai ce duk wannan 3rd civil war din da ake a twitter ita neman kudinta kawae take 	positive
queen din tamu ashe shekaruna daya daita 	neutral
nigeria  tura takai bango nigerian army riot boko haram in sambisa forest	negative
dama achan nake in koyi swimming	neutral
shifa wannan me mafar kin aljanun akwai rikicewa a lamarin sa anya kuwa aljanun da suka shiga tijaniya babu wani abu da sukayi masa amma ayi mai rukiya a gani	negative
kokarin rage bakin jini  ganduje har abada baza ai gwabna mai black blood irinka ba	negative
allah yakara mana son annabi muhammadu saw	positive
wallahi gaskiya ya fada	positive
ɗan sanda dama kunun salala 	neutral
allah ya rufa asiri ya tsaremu yakuma wakar da wayanda suka kamu ameen 	positive
safe trip didi a sayomun awarar gwangwani	positive
baa canzawa tuwo suna kwankwasiyya amana	positive
innalillahi wainna ilaihirrajiuun allah muntuba ka tausayamana	positive
wawiya kawai marar akinyi	negative
the 2 baba are both absent from the debate	neutral
suna son ayi clicking ne 	neutral
wllhy kaga business din de keci a kasuwar dinuya dabadun tsoron kidnappers ba da nayi jeji da qasata a faranti 	negative
since 2013 sai yau	neutral
babu shugaban kasar da dabiun sa masu kyau ke kawatar dani a kasashen european irin sai ta 2 leaders kenn 	neutral
wannan ai keke napep ne	neutral
excuse me yanatan ina	neutral
wlh a harkan nan kamar akwai baqin ciki the way these girls insulting kai kace su saboda rufe jiki ma da hijab suke bacci ku kuma guys sai kun gamma kalle tsiraicin mace sai kuzo kuna wani surutun banza idan gaskia ne kowa yaje ya fara hana qanwar sa shigan banza	negative
alhaji atiku we need the  hows   this sermonization is stale  how do u intend to create jobs what is the present govt not doing	neutral
 director abunda yakamata ayi kenan amma dan allah kada taska ya samu komi	positive
innalillahi wainna illaihi rajiun allah yayi mana maganin wannan cutar da gaggawa bada dadewa ba amin ya allah 	positive
allah ya jaddda rahama a kabarinsa allah yasa ya hutaameeen 	positive
ubangiji allah yakawo mana saukin rayuwa a qasata nigeria 	positive
allah ya kaimu aljannah mu hada arewaaljannah connect  youll be the special guest then insha allahu	positive
ana ta yanda za a koshi kai kana tunanin sakin waka tabb gaskiya kana ruwa	negative
allah ya saka maka da mafificin alkhairi  see your brother 	positive
ameeen ya rabbi allah sir	positive
anzo wajan ina gabatar miki da sabon banki dan yayi wato jaiz bank taken mu shine dan kyakkyawar rayuwa me albarka ki huta lpia	positive
wow ga dama tasamu fah gaskiya kamata yayi inje nima a maqalani 	neutral
oh allah help our baba	neutral
pls n pls sadau din nan kanwar uwar wani ne a app dinnan neku barta tayi abun da taga shine daidai idan taje can ta hadu da mahaliccin takowa yaje yaji a nasa zunuban pls haba ba dama mutum ya bude twitter sai ya ga mgna akanta haba wlh am so anoyyed	negative
allah help our country nigeria	neutral
nigeria vice president debate is today we want see alhaji	neutral
allah ya taimaka atikuobi we really need this combo	positive
a haba dai kai mai kano da kaduna mai gida da wuce kenan 	neutral
zaben kanannan hukumomi gidauniyar fts ta bukaci jamiyun siyasa su sake mara wa matasan gombe karin bayani 	neutral
nasidi adamu yahaya loves  his mum so much	positive
kaiiiii jamaaaa duk wanda suke fadamiki wannan maganganun ba kowa bane yake iya 5 daily prayers amma kowa saiyazo da guntun adsininsa wai shi zaiyi wa azimtsewhar zuciyata zan fada miki wannan kiyi duk abunda kika ga dama bbu wanda ya hallice ki mre	negative
allah yayiwa ganduje albarka 	positive
ga talakawa a cikin halin haulai amma an kaiwa kaji abinci wait wai suma kajin ko ka manta su kansu abinci ne	negative
gaba gaba dai bbc muna nan tare daku	positive
ameen prince yaushe zaa koma nima na shirya kayana	positive
me ke faruwa	neutral
allah sarki  muhammad buhari wlh ina tausaya maka hakkin dan adam akan allah ya yafe maka  ysa sauran allah alumma suma su yafe maka  	positive
lmao kaji wata magana	neutral
hm ba saijiba yakamata dai idan naka yasamu kawai kasan yasamu wai ina biki a gidan sukare	neutral
the mallam ive ever known in nigeria allah ya gafarta maka 	positive
baa twitter kadai ba ako ina sai mun nuna fushin mu a nigeria ne kadai zakayi shekara 8 kana fama da course daya kuma batareda kayi repeating ba	negative
its because itace ma nigeria  gaba daya 	neutral
banda yayan munafukai ne ku bbc ina ruwanku tunda ba siya wa mutane zakuyi ba koku rage musu farashi mtsswww	negative
allah yasaka mai da alkairi 	positive
ya allah muna neman tsarin ka daga sharrin mutum da na aljan  ya allah kada ka bari mu cutar da kowa ya allah kada ka bari a cutar da mu  muna yiwa kowa fatan alkhairan duniya da lahira 	positive
waya aljannar duniyya 	positive
because arewa people are telling you the truth and the right path of good deed you call us as yan kauye so we are still waiting for your second apology tunda mun yan kauye ne allah ka yafewa kowa kurakuran sa na fili dana boye	positive
iam not neutral i want buhari out obasanjo insist kaji tsohon banza	negative
allah yasa yafito acikin sa a my gida adam azango the ameen summa ameen by real yahaya muhd from saudi arabia riyadh tnx	positive
wuta baba talakawa na kara godiya farin tsoho	positive
basugan komai ba wallahi yanzu aka fara 	negative
shi alamarin dunia ba haka yake ba siyasar nan ita ce rigar ka da muka san ka da ita kar kayi ampani da ita wurin cin mutuncin wanda suka pi ka sanin me suke yi	neutral
please kunemo labaran kirkimana kuna maida hannun agogo baya	negative
at the atikulooted presidential campaighn raly in kano today	neutral
allah ya shige mana gaba a wannan zaben	neutral
ta dade bata siya ba	neutral
ahe dama karya yayi mana	negative
wlh ke jahilace harmin manta da wancen abunda kikayi ko	negative
kutumelesi kuna nufin ya bata kamar wata waya  are you thinking what im thinking	neutral
shin kuna sane da irin tafiyar wahainiya da wakar da yan nigeria  suka biya mawaki rarara yayiwa shugaba buhari kuwa idan kuna sane shin ya akayi aka kwana a ragaya	neutral
uwar dakita ai ke ko baki wanke  ba da yardan allah ba abunda zai sameki insha allah dan allah na tare dake insha allah i love you so much my heartbeats 	positive
happy ranar democradiya june 12	positive
fatima gwadabe kinyi kyau sosai 	positive
wai xaka sa shi ah wuta	neutral
kuyi subscribing na youtube channel namu mai suna ash multimedia domin sauraron littatafan hausa novels namu kala kala mun gode	positive
starting process    gaining access    access granted    testing integrity    integrity test passed    testing capacity siyasar bana	neutral
ahh gsk ne wanan ba shakka ansha shagalin bikin aisha hanan buhari don haka sae ayi qoqari a biya kafin a sauka don mudae talakawa bamu san wanan zancen ba yawa	neutral
ashe ba tun yanzu mata ke activism ba 	neutral
congrats allah ya kara daukaka saura na gidan alh badamasi my favourite movie	positive
allah yakaimu gobe sir 	positive
allah ya jiqan shi ya mushi rahma	positive
dan allah kizo mu jefa ki porn industry aradu ba qaramin boosting economy qasar nan zakiyi ba	negative
biri fa dan iska ne	negative
duk mune tuzurai 	neutral
can taje transformer ta runguma tho ina ruwan mu	negative
subahanallah allah kah kawomana sauki cikin gagawa ameen	positive
fatiii soyayyarki takusa kashenifa	positive
sai yanzu suka farka daga barcin bayan wasa ya tashi      lallai demokradiyyar nigeria tayi wayo sosai	neutral
ae ko muma de ya matukar burge mu wallahi allah ya kara basira the great director especially 	positive
allah ya karbi ibadar mu 	positive
ni fa a case din yau nine lawyer dinki 	neutral
 kai masha allah wallahi abu yayi kyau hausa ba dabo ba allah yakara daukaka harshen nan mai albarka jinjina da sarkin yaki da mai gida bangon sikari	positive
ta barmu da bashi mu wawaye cinye du	negative
bamuji dadin hakan ba 	negative
tabbas a fusace yake 	negative
duniya ina zata da mu ne haka	neutral
amurka ma bata san najeriya ba kenan 	negative
rahama kizo kano ki bude mana sadous homerestaurant ace har sai mutum yaje kd sannan gsky yayi nisa plxxx	positive
this almajiri are getting it fast  be care full pdp	negative
dama a lokacin da kake yi musu aiki ne kake da muhimmanci amma da zarar ka samu matsala koto babu ruwan su ban za ye kawai 	negative
amin y hayyu y qayyum aunty idan na fara nawa zan iya zuwa shan ruwa gurinke say something 	positive
axxalimin shugaba na karshe tir 	negative
ba qarya dama a kano nake 	neutral
hege bossba rami meya kawo rami	negative
shi kuma nasa sakacin mai ya haifar kenan 	neutral
suna ragewa idan sun rage gaba daya follwrs sai suke budewa mutun wani acc 	neutral
wannan irin lamari na corona virus kam sai addua kawai mu namu daban ne dana sauran kasashe 	neutral
cut melesi bbr mgna  wlh kinyi halin nki answer daedae d 	negative
ku tambaye shi mana da kanku	negative
tura taya  yaran yanzo yen gayu neh sai skooter ko skateboard	neutral
kar kamanta rara fa    	neutral
wan nan amsar tamun sugar so sai ubangiji allah ya biya ki   	positive
allah yakyauta mukam muna shan kawai	positive
tohhh mudai munga gawar mutum43 a qasa kuma muna fata ubangiji allah yayi masu rahama yasa aljannah firdausi ce makomarsu muna roqon allah ya kawo mana sauqi acikin shaanin tsaro yazaunar da qasar mu lpy ameeen	positive
shegiya weed bbc ashe kuma kukan taba	negative
anjima kadan insha allah 	positive
mallam allah yakara daukaka da basira duniya da lahira wlh inda zanzama marubucin film babu wanda xanba darecta inbakaiba harnagama yayina labari na dai yanakyau yadda bakatunani saidai talla yana yawa sosai akaramana lokaci ko arage talla muna godiya matuka	positive
anyiwa baba tsiyar nasara an wankeshi tsaf farfesa farfesa 	negative
ba abin mamaki bane  tunda kinada daki a niimah hotel daman 	neutral
madrid fan sorry nasan kunsa rai but mai cixo suarez lashe dama mu yan barcelona mun hakura ai 	neutral
wadannan sune masu corona din  akwai allah	neutral
am preferd to whistle efcc to acessbank barayin banza dasu	negative
godiya nake oga director	positive
sai godia director yanzu aka fara	positive
bayan cin mutuncin da muhammadu sanusi na biyu ya fuskanta a jihar kano sai na gano cewa local government chairman ma yafi sarki mukamin from major to less than lg chairman neba eba 	negative
babu abunda zai same mu sai abunda allah subhanahu wataala ya rubuta zai auku damu allah gamu gareka	positive
all dis and dt na scam dole qanwar naqi ta sanadinki anyima annabinmu isgili mara kunya kawae  dawai ribabban jikinki mara albarkan dunia bare qiyama 	negative
yaji alert yafara sakin mutane 	neutral
the atikuobis are serious on claimming the winner of the vp debate alhaji pls calm down is not the real election	negative
rahama ga shawara aradun allah gwara a kama sani abacha stadium sabida rankatakaf din mu zamu zo kallo kuma film house ta mana kadan aradun allah	positive
toh me ya anfanemu dashi	negative
rahama sadau i love u gal 	positive
kullu nafsin zaikatul maut muna miƙa aziyarmu ga daukacin alummar musulmi wa yan nijar allah ya gafartamasa	positive
wace youtube channel ce tafi kowwace yawan subscribersduba 	neutral
kai wace kalar tambaya ne haka	neutral
my kannywood crush 	positive
in sha allahu allah sai ya yi mana maganin ku da wuri ba sai an yi nisa ba tunda mu kun fi ƙarfinmu	positive
baba doesn’t have to debate his achievement for morethan 3 years will do the talk for him	positive
kinyi kyeu sosai baby na	positive
wakar nan tasa guyz sun cii kai dayawa fa zamukai dj ab kara 	negative
said maganar zuwa paris kenan 	neutral
gaskiya lamiraj yayi kyau sosai kaman da gaske sbd allah ya nuna ishara agun masu son suyima allah wayau da shishshigi memakon ajira ikon allah	positive
wannan gaskiya ne allah de yamana maganin su	positive
yakusan tafiya kam amman dai kuma its too hot 	negative
allah kana gani anason cin zarafin wanda kafiso allah ka nuna masu qarfin mulkin ka ya allah na hanama duk wanda zai taba masoyinka ya allah ka hana masa jin ddin duniya 	positive
anya gayan nan ba catfish account yahadu da na wannan mutanen ba 	neutral
hello nigerias sai baba	positive
baba buhari is in daura for the election	neutral
idan aka ce mafi yawan mata masu daawar wayewa ƙauyawa ne sai suji haushi amma wallahi haka maganar nan take bana ganin laifin su tunda su da kan su suka qirqiro qauyawa day don haka shine topic din duk wani qauyancin da ya biyo baya is just a sub topic 	negative
da wanda sukayi kisanda wanda yaji dadin kisan da akayida wanda ya taimaka wajen yin kisan ya allah ya ubangijin dukkan halittu allah ka tura musu masifa da balain da ba zasu taba jin dadin rayuwar su baya allah kasa suyi mutuwar wulakanci 	positive
yaro dakudi abokin tafiyar manya 	positive
yarinyan kirki ce 	positive
allah subhanahu wataàla yajikansu yakuma gafartamusumukuma allah yakyautata karshenmu ya rabbalalameen	positive
tin ina yaro inna tsinci kudi sena siyi masa harkawo ynxu bandenava kutayani da addua nasamu kudi dama nagaji da tuwon gida sekun gaji da kawomin order allah ykawo ciniki	positive
tambayarku da alamr akwai gaskiyar magana acikinta kunfadi gaskiya amatsayin tambata 	positive
ai zuwa zance ne matsalar kaje ka tura soja kace in sallama da wance 	negative
uhm gaskiya a farko namiji ne yake fara nunawa but the finish gaskiya mata sunfimu iya nuna soyayya har kullin 	neutral
wenger kofin premier ya yi mana nisa	neutral
na manya ne	neutral
u see ur life dama baki fada bahdna dinki na yan 9ja ne dole sai an fadi nawane farashin abu 	neutral
a madadin yan uwana mutane katsina da yankin arewa baki daya mun yafe shugaba buhari idan waadin mulkin shi ya kare daga abuja yayi gaba kawai zuwa yankin yarbawa 	negative
watau adduar baya daga cikin abubuwa guda hudun kenan ko domin naga saï da ka gama lissafa abubuwan tukuna ka kawo addu an 	negative
toh mu yan saudiya ne 	neutral
karfa a jawo mana yaki da jamaica 	neutral
wani irin suna ne wannan	neutral
ina fatan wannan labarin gaskiya ne kuma zaiyi trend kuma a yabawa sonojin nigeria 	neutral
dama basu d aiki wadan nan inyamuran sai danfara da safarar kwayoyi don haka suka lalata sunan nigeria a kasashen duniya sbd haka visa ta china  da sauran minyan kasashen duniya takeyi mana yan nigeria wahala matuka sbd wannan mummunar hali nasu  dama raba kasar akayi wlh	negative
akwai rahoton arsenal tana sama a teburin premier da kuma zuwa zagaye na kusa da karshe a champions league in rahotan ni yakasa muku ne 	neutral
haba hauka suke subari yaci	negative
sunci gidan su	negative
 bbc da exclusive labarai	neutral
y allah duk wan da yake da hannu aciki allah ya tona asirin su	positive
dayadda ake bibiyarta haka ake bibiyar tsaro da mun more	neutral
assalam rankaidade taska a taimaka a sakar mana fim din gidan badamasi fitowa ta 9 kar ya zamto cewa bacewar da alhaji yayi ya tafi da mai yimana uploading a youtube 	positive
again anyway atayin haka har layin yakawo kaina nima nadan rika coach din kona sati daya ne	neutral
ya allah ka kawo mana dauki na gaggawa kuma ka hana duk mai hannu wurin tafka irin wannan taasa shakatwa tun daga duniya har lahira	positive
mutumin daya kasa siyan form din takarar sa shine zai bada gudumuwar nan  allah ya isa kudin mu	negative
 kaji wata bahaguwafah	negative
allah y s albarka	positive
su da chi mu da wanke hanu	negative
 allah sarki ubangiji allah ya gafarta wa abokina da sauran waɗanda suka mutu acikin wannan haɗarin	positive
masha allah  shugabana mai daraja uban abba hakan wannan matakin daka dauka yayi said ai allah ya kara ma lafiya khadimul islam	positive
to ku wai daman sai yanzu kuka sani	neutral
 sarauniyar matan duniya fitila mai haske ruwa kan duste	positive
wow yanzu nima kenan zan iya nade kafa kawai nace ni da rahama  	neutral
wnn maganar fah karya ce babu covid 19 a katsina wlh babu ni  dan daura ne kuma muna jii muna ganii  zaayimana karfa karfa a cocemu wlh wlh babu covid 19 a daura	negative
idan yaxo yayi maganar dollars  kace masa film ne	negative
azumi alhamdulilahi fatanmu shine allah yakarbi ibadunmu dukkanin musulmi 	positive
kano tumbin giwa ko dame ka zo an cika	positive
oga kaima kana crypto ashe 	neutral
kinyi kokari kema allah ya shiryemu baki daya 	positive
shinkafar 30 ake bashi yagudu	neutral
ɗan tsuntsu bayada tarbiya he deserve to inpeach 	negative
woww lolharda rahma asheamma wanda kika sawa wannan sunan yaji dadinsanot bad name 	positive
gsky nima dae a nawa raayin lukman ya dace ta aura domin sai yafi kula da ita da kuma nunamata soyayyah	positive
dan allah amaido mana en uwanmu	positive
no doubt yakamata su hadamishi dana bakwai takwas tara da goma	neutral
karya doka ne yafi burgeni dakuma na sama ya taka na kasa ba abinda za ai	negative
gaskiya dai ana dora mana laifi da yawa a wannan shirin 80 na rashin na rashin mutinci duk maza ne wlh dazun nan wata take kallon wannan tallan wai take cewa ai namiji dan akuya ne nace to ai kece akuyar lolz	negative
masha allah  allah yakara masa daukaka da lfy	positive
minister wutar lantarki abubakar shekau albornawy yace sai sun shekara basu ga wutar lantarki ba 	negative
allah ya jiƙan su amma su kansu jiragen ruwan a samu masu lafiya da kayayyakin ruwa wanda mutum bazai nitse ba allah ya jiƙan su ameen 	positive
that venue is not baba buharis natural place of association  those folks gathered there  are educated and peace loving people	positive
allah ka hada kan musulinci da musulmai na duniya baki days	positive
allah ya yafemana zagin wanda ya mutu akan abunda bai gani ba baiji ba ina madafa waye mai gaskiya	negative
 wlh bbc hausa baku da aikinyi kishiyar kakan obama mtseww	negative
irin wannan dalilin rashin yanke hukunci akan muggan masu laifin cikin ƙasar nan ne yasa nake ji araina yanzu ko nawa gwamnati zata bayar a matsayin bashi ko makamancin sa wlh bazan biya ba kuma duk wanda zaiji shawara ta shima bazai biya ba 	negative
nayi bakin ciki rasa damar kallah 	negative
 wlh duka zasu sha a wani lungun	negative
azumi na jijiga knn 	neutral
na sara musu gaskiya 	positive
matsalan ba su bayar bane at the end talakawa me da asara saboda dole zasu nemo hanyar dazasu mai da x10 na abinda sukavayar	negative
ashe har kafi dangote ma suna a duniya tramadol in action 	negative
dan allah wace hanya zanbi in shiga villa ba tare da jamian tsaro sun ganni baina da shawarar da zan bawa shugaban kasa ne	neutral
allah kyauta kuma ya kiyaye gaba 	positive
school is full of stress hajiya ina zama graduate mun raba hanya 	negative
tabdi yasin sun jaza mana karshenta muma sai ankaimu litinin ko talata 	negative
lokacin dayace yana buqatar soyayyar laila saida nakasa zama naji kamar nashiga cikin tv din nafara suburbuda mishi tafi har aka gama mamana tana mita da surutu kamar da gaske yafaru 	neutral
allah yayi masa rahama yakuma basu hakurin rashin sa 	positive
nigerians are dying everyday due to the incompetence of baba mbuhari he has to go back to daura	negative
gaskiya bazai kawoba kawai kufasa haska film ɗin zaifi	negative
shima taska ashe yanada vpn	neutral
subhanallah allah ubangiji ya kawo mana agaji	positive
hhhhhh  nan kam an wuce nigeria 	neutral
wallahi kar wanda ya kuskura a bashi raigakafin korona billahillazi domin wannan maganin akwai wani masifaffafen asit a cikinsa not in we dont need it	negative
toh allah yasa ku samu mutane sukai hamsin kefa fans dinki kauyawa ne nan kuma birni ne	positive
allah ya kara masa lafiya da nisan kwana go ahead 2019 in sha allah 	positive
uhmmmm eh kinga kamar ni yanda nake sonki kinga ai said ki so ni koh	positive
happy sallah allah ya maimaita mana da rai da lfy	positive
miliyan hamsin wuuuuuuuu sai bayan kwana biyu	neutral
kaduna ya biya mana in kind 	neutral
hasbunallahu wa niimal wakil allah ka muna katangar karfe da wannan cuta ta corona ya allah ka hana wannan cuta zuwa yankin mu na arewa dake da matukar raunin tasarin kiwon lafiya da kuma yawan matalauta	positive
bbc hausa nigeria kai muke jira ka rufe naka	neutral
ae sunsan inda yake 	neutral
nima inaso gsky ammafa banada ko nairasaide kumanihandsome ne gsky	positive
yes why not you kawai kiyi aurenki ki rufama kanki asiri	positive
humm daya kawai  sojoji fa ba soja ba critical thinking 	neutral
dan tsurut zaisake kulle jamaar kaduna sako daga washington dc kusa da gidan shugaban kasar sambisa gefen offishin donal trump muna allah wadai da wanan batu naka kiriku 	negative
wanan haka yake my top celebrity	positive
wannan kusar kanshi ta kwance akai durkushewar da tawuce aita kashe mutane ana sacesu ana kwashe dukiyarsu ana rabasu da mkrnt da kauyikansu da ahalinsu mahaukaci kawai	negative
ya allah we are sinners forgive us ya allah sannan kema allah ya kara ganar dake 	positive
masha allah looking beautiful allah yakara daukaka	positive
yanxu tana nan tana saka maka albarka ta dauka kai dan arziki ne this one weak me very well wllhy	positive
allah ya karawa kasarmu zaman lafiya 	positive
wallahi babu wanda zai min gwajin coronanothing like dat	neutral
aida kun bincika dawa kenan akayi yarjejeniyar karkashin jagorancin wane shugaba kai amma abin rainin wayo wai zaa rufe cbn	negative
toh zaman mai kikeyi a wajen	neutral
ni abinda ke kara bani mamaki anan shineance wai namijine yayi recorded din bidiyonhow come she take off her clothes agaban namijin da ba maharramintaba sabo allah to be honest the guy leaked the clip was wrong  but her careless was 85 in the incident 	negative
tohallah ya dada kare mu baki dayaaameen	positive
ni sai yau ma nasamu damqn kallon film din nan lalle da alqmu wannan season din zata fi nabaya dadi dakuma sa nishadi happy jumuat kareem 	positive
febuary 16 2019 ce ranar zaben shugaban kasa a nigeria	neutral
yadai matsa saiya rufe garin nan ko 	neutral
ba komai allah tabbatar mana da alkhairi 	positive
kina da kyau wlh kuma kowa yasan kina da kyau sai dai a dawa na yan uba please ina mai bakin sha wara kin daure kiyi aure tun duniya tana yanki haka shine zaisa babu wanda zai iya mantawa da ke a tahiri allah ya bakin ko da kuma allah ya bakin mijin nagari ameen 	positive
eyyah kuma harda ku ai nasha mu kadai ne sorry ehn	neutral
100k duba da kuda den da aka tara idan aka raba su x 250000000 kowa zae sami 84k ita kuma fg a nata gudun mawar sae ta cike gibin a bawa kowa 100k if possible 	neutral
haba china mun duka kasa muna baki hakuri corona din ma bata wuce ba kuma zaki kawo mata wata haba haba dan allah	neutral
tunda kun kasa yi masa interview muji me ze fada mana ai se ku rabu damuko wa ya fada muku beji dadi ba oho	negative
ya subhanallah allah ya gafarta masu its really painful 	positive
hhhh wlh abun yana bani sugar lockdown mutanan kaduna state zaku koma kenan a gaskiya lockdown dinnan zai matukar bada chitta  ku wanke hannu ku zauna a gida sannan ku cigaba da bada tazarah inji sarkin yakin covid19 nasir elrufai	neutral
alhamdulillah sanusi jikan sanusi  sarki jikan sarki  khalipha jikan khalipha  allah ya jibanci lamuranka gaba daya bijaahi صلى الله عليه وآله وصحبه وسلم	positive
idan shugaba buhari najin shawara nan take ya kamata yayi gaggawar sauya jagorancin manyan dakarun kasar nan kawai nan take muga sauyin a kasa 	neutral
mai arziki uban matsiyata uban talakawan nigeria masu arzikin ma kai ubansune waziri uban turaki shugaban kasar gobebaba atiku	positive
na san za ayi gida da waje 	positive
waye wannan zai yi min kwacen rahama 	negative
wlh duk wanda yake da sa hanu a wannan batanci yayi gaggawar qarya ta kansa kafin uban giji ya damqe shi wlh 	negative
kai gaskia kanawa sun jima da yawan taxurai	neutral
kunada yawa ai masu kudin sedai ke baki bamu namu giveaway din ba  from your side	neutral
this is the almajiri rulers and their systems of government	negative
what is this for love of god haka zamu rika zama shuwagabannin mu suna cutar mutane don neman mulkin banza 	negative
hava wasa ma kenan	neutral
allah ya isa da kika sa aka ci mutunchin annabinmu da addininmu mun barki da allah zai mana maganinkiin kinga dama kiyi tsirara ma kiyi posting a dunia wannan ke ta shafa	negative
shugaban kasa da cabals	neutral
maryam kiyi hukuri da abinda a kayi miki duk wanda yatuzarta dan uwansa muslim allah sai allah yatuzarta shi maryam stop crying god bless u with all blessing	positive
allah ya ja kwanan baba 	positive
allah ya taimaki musulunci da musulmai ya kaskantar da kafirci tare da kafirai ameen	positive
fulani ai haka suke dason bredi da kosai 	neutral
mufa yan dodar ne	positive
da matin da uwar matin da uban da ya haife matin duk sunci uwatai 	negative
allah yasa ka fara tausayin talakawan ka sanadiyar hakan musamma mutanan maiduguri da suke rasa iyalan su sanadiyar boko haram 	positive
rahama yan mata 	positive
yaya ali nuhu ina maka fatan alkhairi kai da iyalinka my lovely u	positive
miliyan hamsin wuuuuuuuu sai bayan kwana biyu	neutral
fadan da ba ruwanka yafi dadin kalloh 	neutral
kuma ake anfani da pos 	neutral
me yake nufi to 	neutral
tab aikuwa yanxu ba makawa yana nan yana karbar horo yadda yakamata dan kuwa wallahi walakiri no fear no mercy	negative
kowa na karbar tsabga bbc ma sun rasa labarin da zasuyi posting sae kamekame 	negative
tsinin gindin durumin durin uwar mamansa da kwallon da masu zanga zangar	negative
tsuntsune zai hau pole boom zakaji ance wuta tasamu matsala wani abun sai naija	negative
baba don  t know d meaning of orphan  atiku no sabi wetin him de talk na ben10 force am	negative
tunda da kudi ai za a kawo sauyi kuwa 	neutral
su anty rahama kenan 	neutral
elites doing elites stuffs toh ba xai sauka ba sai tuwonti tuwonti tiri ehe 	neutral
jarumar matan kannywood	positive
wawuya waike kina washington dc banza kasar dabanakiba harkina alfahari dashi waike kin waye  yau inasu judge floyd	negative
koma dai me akeso ace is doesnt make sense pls mutum dai yasan fans din nashima hausa sukeji amma se an musu gwaranci	negative
point of correction qaryar da dai ya gayamasu	neutral
mati a zazzau will be on   	neutral
yarasum ne kawai yake damun su 	neutral
ni nigerian ma state 4 kawai naje adawama taraba gombe bauchi	neutral
allah ka sa kada muji kunya wannan zaben	positive
aminiya kuke ko to uban ku ya daki hancin uwar ku daku da zaben 	negative
kwaluba covid 20 is loadingallah ya tsaremu	positive
subhanallahi ya yi rubutun nan jiya ya kuma rasu yau kai allah ka karɓi ranmu muna masu imaani da kai take note	positive
and co  not only rahma and hadiza gabon or nafisa abdullahi the rest of you girls all allah ya shirye ku ku tuba muma kuma allah ya shirye mu duka amen	positive
matsalar bbc itace kawai sudai suyi posting subarka da comment ko replying na iska da ace zaku bada sakona da sai in fada amma kullum kodai muyi muku replyn haba	negative
haka dai aunty aisha allah yaji kanta tace kudai kuga aure the same thing with ur words allah yasa mu dace 	positive
a fito da su ina wai halin da muke ciki bai ishe mu sai mun kara jajubo wasu balain a barsu kawai	negative
idan ansamu iphone 1 in aso	positive
allah shi karo na kullum kullum	positive
first frame anty surutu 	neutral
agaskiya mu yan nigeria ana matukar raina mana hankali ai koh kirge ake koya mana da wannan karekaren yawan masu corona a nigeria ai yaci ace kowa ya mallaki kwalin degree a lisaafin na kirge	negative
dama haka takeso	positive
director film yayi kyauallah ya qara basirashikenan an zo wurinku kai shi cell	positive
ku abu anyi shi ya huce sai kun sake tada maganar 	neutral
allah ya baki mafi alkhari miss sadau	positive
amma da sukace akwai poison acikin shinkafar 	negative
hmmm toh ay nima shine nagani	neutral
toai dune many an yanbokoharam din	neutral
baba galadima is a member of the apc hes also the spokesperson of the pdp presidential campaign	neutral
waiyo allah waiyo allah mudai munshiga uku kalu innalillashi wa ina ileshir rajuun ilimunne baa bukata 	negative
anfi karfinsu ne kawai a jiya 	neutral
dada tsufa ya kamani nisa fa tazo kusa kenan 	neutral
look at this girl obasanjon ne dakiki hhhh kinaruwa aiko agidan soja ehh yana gaba da ehh 	negative
sama wannan karon var bata yiwa liverpool adalci wannan magudin yayi yawa fa	negative
innanillahi  wannan wacce masifa ce	negative
kwado ya fada ruwan xafi	negative
anjima zaa fitar in shaa allah  wait for it h	positive
allah yasa mu dace  everything will be ok inshallah allah ya kiyaye gabah	positive
i have no enemy in nigeria  i inherited nigeria s enemies  if i compromise  they will be my friends  inji shugaban kasa	positive
saura naji wani banxa yasakemin mgn ankusa koma skull	negative
aikin banza ga masu zamba can a office ankasa hanasu	negative
innalillahi wa inna ilaihirrajiun  allah ya kawo mana karshen tashe tashen hankulan nan allah ya ji kan su ya sa mutuwa ta zamo hutu a gare su amn	positive
inama ace garin mu ne 	neutral
mutumin ki nefa 	positive
u look so gorgeous rahama	positive
allah jiqansa allah yasada shi da annabin rahama ameen yahayyu ya qayyum	positive
wayyo musulunci dadi	positive
alhaji atiku  i and my family  kindred  kinsmen  ward  village  town  local government  wish you well in this election	positive
mstwww shirmen is banza anjima anafadan ire iren su bamu gani akasaba 	negative
gaskiya y chanchanci a basu minister saboda suma yan nigeria ne koma makantansu baihanasu zuwa wajan zaban shugaban kasabamr president u supposed to look upon ds guyz too	neutral
hajramatu kin gaji ne	neutral
bafa sequel din saa dai zamuyi anan ba   	neutral
masha allah allah yaqara daukaka yakuma kareki daga sharrin mahassada sis 	positive
romeo nd julio ma sunchi uwarsu	negative
mufa gaskiya ba wannan ne matsalar muba habba talakawan nigeria suna cikin wani hali ga rashin tsaro ga talauci ga rashin aikin yiya ilahi wai shuwa gabannin nan kuna sane da cewa zaku je ku tarar da ubangijin ku kuwa	negative
to da kuma beci ball dinba uwarsa xai basu shege dan asara	negative
wannan shine mutumin da ya saka miki hannu kika shiga harkar film kenan tirr 	negative
wata sabuwa trump fa yana so yayi inconclusive	neutral
amma fa aunty naso nayi rakiya wannan wurin	positive
wow very nice rahama 	positive
baku gaji da satar kudi da its ba kenan 	negative
hhh anayi munajin dadee	positive
sei a yankashi a cire 	neutral
kune kuke diba kuke raina mana hankali kenan	negative
allah y kawo dauki amin 	positive
wai da gaske a prison take tweeting  allahu yasa ba haka bane	positive
irin ta ji abin da ya ce din nan 	neutral
himm yanajin tsoron kayin daza ayi masa ne yagudun kai nai ya fashe 	negative
mata yen baiwa a haifeku bakake idan an girma a zama farare  hausa	negative
ina kaso 90 bawani 40 adai duba jiwa in nn fa 	neutral
karon farko kenan danaji el rufai ya birgeni matuka yayi abinda ya dace wlh allah ya karpapeshi akan irin wanga aiki	positive
why na abin harda subscription naji yanzu sunce duk shows dinsu zai koma nan dole sai ka biyalalle da rabon zamu koma kallon free channels dinmu na da	neutral
zaria massacre  da kuma lekki massacre akwai evidence dan haka abin a fili yake komin karyar da lai mohammed zai sharara	negative
gaskia a mayar musu da dokin su	neutral
yayi daidai wlh allah yasa bazasu dawoba saura ahana yan sanda karbar kudi a hannun matafiya akan hanya	neutral
ya kamata kafafen yada labarai su dunga fadar gaskiya which one of you telling liestruth	neutral
allah yasa alkairi rahma allah ya biyaki da alkairi allah ya kara arziki mai albarka	positive
baba no go ooh   na trap oh buhari  who wan go before   you well so	negative
talauci da yunwa yayiwa mutane yawa daman kayansu ne kuma suka kwashi abarsubakaji gwamnonin tsit ba jikin takaura yayi laasar basuda ta cewa gwamnoni dai an fadi shirim ba nauyi 	negative
ku tsoro kukeji ne da kuka fidda kanku zakuce wani inji yan twitter dan uwarku yan bbchausan boro uba	negative
allah ya saka making da alkhairi allah ya kare ki daga sherin duniya allah ya baki abunda kk nema duni ya da lahira 	positive
tsinnan nu mara sa fadar alkhairi shegu jakkai matsiyata dan uwar ku saidai kune zaku dinga faduwa kuna mutuwa hegu diyan asaramtswwww	negative
15 billion ta fara aiki	neutral
congrats to uvaid s becca dillingham  lagniappebabe  and team on the recently published 12 month outcomes for their mheal an gaisheku	positive
malamai magada annabawa dai dai ne mallam allah yasa hakan shine mafi alheri amin 	positive
to yan iskan banza kunki aure amma kuna karuwanci idan akamuku maganar aure sai kuce lokacine eh lokacine amma idan kukayi wasa lokaci zai iske ku amakara	negative
allah yasa mudace idan mun dace mudafe 	positive
allah ya bamu alkhairin sa 	positive
ameeeeen ya allah malam aminnu saira	positive
ikon allah knn haka allah yake alamarinsaya allah ka dubemu da rahma allah muma kayayemana da duniya baki daya ya azizu ya jabbar	positive
ai gaskiya banda choice for now adai cika alkawari kawai 	neutral
kace talaka baiga komai kenan	neutral
kira mu united nations kawai	neutral
hmhmhm  duk acikin zafin fadiwa a zabe ne	negative
hhhhhhh  wannan itace ƙasata ta haihuwa najeriya kaji wani labari irin na teburin mai shayi to fisabilillahi meye amfanin ƙawanyan da jamian tsaro sukayi musu mu buƙatarmu anan itace a kuɓutar da yaran daga hannun ƴan taadda amma batu na gaskiya gwamnati ta gaza	negative
duk wanda ya turawa rarara koh rariya neh ma sunan nashi kudi a kan a yiwa buhari waka kuma talaka na neman kudin abinci toh wlh ban yafe	negative
hmmmmm dankarii sai a dinga kulawa sosai ta yuwwu ma kenn akwai wadanda ba mutuwa sukai ba an kai su mutuware allah yakyauta gaba	positive
ni dai wanda yafi kawo nakasu na sani buhari	neutral
idan sunga dama suce haramun wannan kuma ruwansu 	negative
mai yasa bakuyi kira akan tallafawa talakawa ba akan abinda zasuci idan sun zauna a gida	negative
like father like daughter masha allah im happy for you sis may allah forgive my own and grant him jannatul firdausi da sauran musulmi baki daya ameen	positive
ko shine yayan namu	neutral
sauran ma sun gaji su miƙe 	neutral
wato na nigeria bama na duniya ba	neutral
hehehehe kinga sabulin salo nah samu dah kuma tamunkuli i hope kinsa kinsan su kulin saena wanki hannu sau 62 	neutral
wato na lura celebrities basu liking ko comment ko re tweet tweet saena yan uwansu celebrities	neutral
allah yanuna mana naki shilatu	positive
to kekuma meya kawo ki keda ba yar hausawa bace kefa yar fulani ce ki bari sai ranar fulatanci zamu taya ki murna 	neutral
muna godiya aunty rahama 	positive
ameeeeen ya rabbiwe really miss u	positive
samu yafi iyawa 	neutral
barka da fatan allah ya karba ibadunmu sannan ya baki miji na gari	positive
kodai daga sunan sumayya aka samo suna mayya ne irin wannan naci haka	negative
bbc amma kuna so ku jefa wasu cikin wuya	negative
wtf even is this timeline people will call baba	neutral
muma mun yi tir da irin wannan mataki a matsayinsa na shugaba	negative
ba kullum akan kwana a gado ba	negative
ehn bunduga now is monjo turn wlh xaku hadu d pishin monjo 	negative
inshaallahu xamu wuceta allah mu muke roqo ba hangenku ba sannan muma mu kula dan allah jamaa da kuma addua 	positive
say the truth koh xaa yankaki nrh tuwo dai hajiya 	neutral
kar a gaji dai da wanke hannu da sauran lokaci 	neutral
kai wannan karyane 	negative
ko sauro mutum ya kashe za ace ai baba buhari ne mbuhari	negative
please miss universe 1922 i wanna know are pregnant ne ko kuma koshi ne kawai naga cikinnne da gwiwowin sun kumbura 	neutral
i miss dikko 	positive
i see the vp or any form of poilitical debate in nigeria as waste of time  because our society is dogmatic and biased sankanmu bazai kaimu ko ina ba	negative
laifin jack ne	neutral
ameen ya rabbi wlh washa yau har 600pm ina cinema ina jiranki amma shiru kuma na tambayi yace zaki shigo	neutral
allah ya biya ku da alheri ubangiji allah ya idda nufi	positive
allah ya kasu lafia	positive
ashe shegen mijin hajiya ne 	negative
allah ya muna sauki ya allah 	positive
ae sayar damune akeyi suddenly xa axo a kwashemu a tura gona shikenan munxama bayi	negative
allah ubangiji kakawo manakarshin fitana	positive
hmm wai buhari ina kudaden da ka kwace a hannun maaikatan gwamnati 	neutral
popular hausa musician rarara rejected a n100m offer from the officialpdpnig presidential flagbearer  alhaji atiku	neutral
wlhi kunji kunya ashe dama ku yan madrid ne bakomae akwai allah	negative
kin riga kin samu duniya abu daya ne yarage baki samu ba ko ma nine ki aminche da ni mana	neutral
bazawara tana smile	positive
allah yakara tsaremu da imaninmu	positive
ki godewa allah  if ur father is nothing a 9ja to yayan su ma is nothing yaran su abin da suke yi a  ai yafi wanda kikai  allah ya yimana gafara gaba daya we are all together 	positive
allah ya ji ƙan direban ya bashi aljannatul firdaus  ya kamata gwamna ya siya masa mota bullet proof koda daga aljihunsa ne allah ya kiyaye gaba 	positive
ya allah ka ya kawo mana ƙarshen matsalolin tsaro a yankin arewacin najeriya da ma ƙasar baki ɗaya 	positive
durin uwarsu har petur din	negative
kaga wiyan ganduje	neutral
allah yayi maka albarka episode din yau ya bada chitta 	positive
eh wanan gaskitane ai videos bavocalbame shiyasa kuma kunsani ai	positive
idan an kama su aba alkalin hukunchin case din 	positive
kudinka izininka  allah yasa mudace	positive
yanzu duk sa wakar rariya da suke maki a shanghai haka zaki che masu	neutral
maganar gaskiya napi tunawa da man petr  allh yay masa gafara	positive
 yaga alamar zai manna masa hauka yace i give up	negative
nifa haushinki nakeji wallahi in naga hotonki sai naji raina yabace wallahi	negative
yaa allah yaa rabba yaa malik yaa jabbar yaa allah kaji qanmu ko muna raye komun mutu ko a qabari ko a dandalin alqiyama	positive
wallahi even if i see buhari stealing with my two naked eyes   wallahi bashi bane aljanu ne zance next level baba	positive
tambaya  shi usman dake karkara kumafa miye matsayin sa domin alamu dari bisa dari sun bayyanawa duniya cewa yanada wata boyayyer manufa dan bazaiyi wannan zaƙewar abanza ba	neutral
ki yi mana chinese kawai	neutral
toh dama tunda an rasa wanda zaa wake ai dole a koma ga yahoo yahoo toh tell him ko biyar ba zamu bashi ba	negative
bashi da hankali ne shiyasa ya manta akwai allah ya isa a kansa tapi 10million ta mutanen kaduna 	negative
ina ruwan biri  da gada kuma 	neutral
what are you all doing about this ongoing asuu strike  it s affecting us badly baba please help	neutral
up up presidor sai dai kuma lukman hwa nanan gefe	neutral
kwarai kuwa ko dan ma su yi uzuri aikin jahili ne 	negative
kuma dai da gangan kuke wahalar da kanku kun manta ance hauren giwa nada dara a china 	neutral
pls asa shi ko acikin yan yinin shabiyar	neutral
harda masu bendown select	neutral
inkunga dama kada ku bude har madi ya bayyana	negative
allah ya isa wlh bazamu yafemiki ba allah ya isa allah ya isa allah ya isa  subhanallah kece silarcin mutuncin dan datan allah saw allah ya isa wlh 	negative
gaskia yakamata animal right tashiga maganar nanantambayeta wata kila tana da uxiri tayuwuma jego take	neutral
wae ba dabino bane 	neutral
guarantee meaningful citizenship  responsive and accountable governance atikulatedyouth youthsforatiku atiku9ja  baba atiku	positive
 zance na hanun malam suleiman muna saurare	neutral
sai dai kayi ta a game kuwa	neutral
shiga wuta direct 	negative
hehehe shegiya da kai kamar dandaliif u know u know kawai	negative
anyway let use jan biro to help you brother	positive
ko yan iska wai zatayi chasu just imagine	negative
u guys have some ausome production gaskiya allah ya taimaka	positive
yaci ribar ciniki 	positive
kice mata allah ya amsa don ya amince 	positive
 wani abu sai turai allah ya kyauta gaba	positive
baba buhari ikon allah yadda ka soma lafiya haka za ka gama lafiya in sha allah ko yanzu alhamdu lillah mun gani a kasa allah ya sa ka gama lafiya 	positive
na bi roko da gudu har london kun iya kawo labarin mutuwar tsohon dan sanda amman baku iya kawo labarin kashe hausawa da akeyi a oyo ba daman wani tsoho a unguwar mu ya dade da tsine muku tun fadan amerika da iraq lokacin saddam hussein	negative
allah yabada ikon haka director 	positive
duniya kenan manyan sai tafiya suke allah yajiqanshi da rahama yasa aljannar fidausi ce makumarsa bijahi rasululah s a w 	positive
gasar premier southampton ta bai wa mamaki da ci 20cc 	neutral
allah ya isa our feelings for this great man is always touched by these ppl  where is the tolerance here allah ka saka mana su kuma masu yi allah ka shirye su kamar yadda ka shirya dan holland wanda yayi abaya in kuma ba masu shiryuwa bane to allah ka tsine musu 	positive
wai daman tana raye ne	neutral
gamu tareda yan family  naku muna dunkin tela tailored a argungu	neutral
wanda a lokacinsa aka kashi babban malami sheikh jaafar mahmud adam ya kasa nemo wadanda sukayi wannan mugun aiki a hukunta su har ya samu baki game da magance harkar tsaron kasar nijeriya 	negative
 bidar kudi kenan	neutral
dakaji kasan wanda aka hanasu zuwa masallaci da coci ne sai yasa kaga cutar ta kama yaransu domin sunqi bin dokan zuwa gurin ibadu	negative
tayaya zamu gane 	neutral
allah dai yayi mana sakayya 	positive
karyane kuma wannan yau dinnan yayi hira da yan jarida amma be fadi wata magana makamancin haka bh hasalima kalaman kwarin gwiwa yayi akan dan wasan a rage ta gobe ko a sha koko	negative
hakan shine dai dai ne  allah ya zaunar da kasar mu lafiya 	positive
allah ya kawoma kasata zama lafia	positive
pls a wane kasa ce wannan abun 	neutral
kin tuna rariya kenan baki da waya kai saka sayo iphone8 is now available in the market	neutral
دجاج mana kaza kenan soyayya	positive
spain da tara akan yan boll	neutral
sadaukarwar da yayi wa nafisa saboda farin cikin tah 	positive
lallai yashiga uku 	negative
more talent to you sir gskia yan kwana chasain sai sun dage sosaii in ba hka ba zai musu overtaking	positive
ai kune kuke jama mutane balain see this girl  haba nan zakizo kina mana kuka 	negative
i dont know why people use to talk about somebodies life kowafa shikadai za asa a kabari dan haka kowa yayi rayuwarshi	neutral
bbc munafukam allah shegu meyasa baku irgo garuruwan da aka haifi isiaka oladayo da leo irabor ba amma kun irgo na sauran shegu	negative
inkun kamu karku sha	neutral
ya salam allah ubangijin rahama ya kawomana karshen wannan annoba 	positive
 taya mutum zai kwana biyu cikin rigar bakin mai	neutral
girman dan mutum ba wuya super 	neutral
hahahah alolo ai yayi biyunka 	neutral
sister rahama wai yaushe zaki dawo nigeria mun yi kewarki	positive
kuma shugaba buhari yakasa yin komai akan wannan alamarin tir gsky akwai matsala wlh 	negative
mexan gani haka presdo takeba fulawa	neutral
shima yasan abinda yayi baidace ba ace alummar da kake mulka tashiga wani hali kuma kanaji kana gani kayishiru ai abin baiyi kama da dacewa ba amman babu komai akwai allah	negative
allah miki albarka rahama	positive
innalillahi wainna ilahirraj un 	positive
pdp they suffer tension caught by karma	negative
ways zai siya kuma	neutral
cin zalin yan babu ruwana wallahi duk sanda antidaba zasuyi hatsaniyar da yan iska toh basa iya komai sai dai zalincinsu ya kare a kan yan babu ruwana	negative
gsky rahma ki godewa allah kina da masoya sosai may allah protect u i love u so much	positive
wallahi in na yadda ma yaudaran kai ne	negative
saurari daka a gidan uban wa an ce me bahaushe yake nufi amma kuna ta asaurari daka a gidan uban mu 	negative
why should baba atiku make such a big mistake coming out want to sell nnpc like nepa andnpa services to himself like intel	negative
wai bbc mai yasa kun fiya sakawa kano ido ne ga lagos da tapi kowacce jaha yawan masu corona amma kollon kunfi fadar na kano 	negative
now baba atiku has chosen peter obi as his running mate  our options were obi or okonjo iweala	neutral
raka asara da guda	negative
gaskiya y kamata ayi protest akan hakan tun kafi ya gagare mu	neutral
nima har ynz ina nan ina waiting legend tayi kira na to watch it for free	neutral
billahillazi ko a mafarki banaso nakarayin irin sallahr nan	negative
kudan yima guy dinnan uzuri yana danjin tsoron gan dollar ne kar ya janje masa tallafi	neutral
wannan soyayya da sumayya kewa mahmud bazata taba faruwa a gaske ba don banga irin namiji da zaayiwa wannan kauna ba idan banda sumayya yaushe rabon duniya da auren soyayya	neutral
let all the lagos finish ba abinda ya damemu  shekara 13 kenan ana kashe musulmai a arewacin nigeria irinsu maiduguriyobekanozamfarakatsinaadamawa ba dan iskan da yayi magana sai yanzu da abin yazo lagos	negative
1 naurar cire kudi 2 naurar biyan kudi 3 kudin shiga yanar gizo 4 bayanai musamman na dandalin sada zumunta na whatsapp 	neutral
ke bafa dan kannywood bane maulan yawuce industry dinku har anfara tsallakawa kasashen qetare kenan wajen jajayen fata i hope hes in yer followers list	neutral
uwar mai sabulu ake cewa 	negative
ina social distancing din yake	neutral
alhamdulillah am happy for zainab allah ya fitoda sauran da suke cikin irin wannan hali kuma basu samu mai cetosu ba	positive
sultan of sokoto no be sarkin musulmi amma dai iya sokoto kahana sallar idi ko mudai kano sai munyi wlhi	negative
wlh wasu mutane akwaye raiyenin hankali garesu tayaya zaa cewa bisa kuskure bayan yasan banashi bane wannan bawai kuskure bane daganganci ne tonda yasani ya aikata 	negative
kuma sai kukayi taro babu gayyata	negative
mtsw wai talakawa as if dey really cares	negative
tohkuma nasan kuke damu class da surutu	negative
and sowhats wrong with thatshikenan kuma don shi malami na bazaiji dadi ya sayi gidaje yanda yakeso ba	negative
inaso nayi participating a akushi da rufi plx	neutral
wallahi abin na da ban haushi ga dariya sun kwashe ne kawai dan government suji haushi amma badan amfanin kansu ba	negative
ai kam badai munci daria ba allah yakaro dauka fadorayi congratulation sir	positive
shegiyan izala shima yanaso yafita da fitarsa	negative
suwa suka fara	neutral
sai ki kara sako wasu yan iskan hoton naga tunda kin fara maganar birthday month dinki	negative
hmmm bama sanyi ne akeyi ba a najeriya hmm kowa nata wani ihu sanyi sanyi 	neutral
uhm  kanku ake ji ni na yi nan 	negative
is it tantabara or tattabara 	neutral
kuna tsoron kar ya kullu ku ne kuma 	neutral
can da yawassa neman arziki ya rufemaka ido don kare hakkin kasarka	negative
tabbas zaifi twitter zukar data 	neutral
duk da takun kumin sa	neutral
we in yola we are safe insha allahnd i hope this shitcovidiot will end before allah yasa dai ba karya ake yi mana don a saci kudin mu bah	positive
shugaban kasa namu gwamna namu sarki namu munci gari  if you know you know	positive
daman munasha ae amman banda wanka 	neutral
everything going as expected inji hukumar inec ta nigeria	positive
god bless you sir  kuci gaba da wanke hannu kawai akai akai 	positive
uhm kaga heroes an kawowa tweeter harine	neutral
bamuda ani abin fada da zaisa manyan arewa shuwagabannin mu suji su dau mataki babu shi amma wallahi ana daf daf da mu dau matakin gaggawa kan wannan mummunan wulakancin da ake yiwa yan arewa	negative
baba yayi magana fah anan  allah ya gyara kasar mu nigeria 	positive
ai mu mun dade da corona kaine na farko kafin second corona tazomun dade muna ganin tsanani	neutral
wannan kuma sai kunje kunyi hira da alkali da ya zantar da hakan sai ku kawo mana amsar a nan media a nan ba mu da amsa	neutral
cc tsabar kamar da kukayi da guy din nan bbc sunyi reporting as mustapha	neutral
eh bamayi bamayi ba wanan abune maikyau musamman idan shugaba ya gaza wajen bada kulawata musamman akan alumarsa	negative
jamaa shikenan mu yan north east haka banza a ka barmu wallahi cutar tayi yawa yanzu wannan maƙudan kuɗaɗen wai aikin hanyar mota zaa yi a kudancin najeriya tou allah shine gatanmu	negative
dama ba musulmi bane	neutral
cewa zan karanta ingattatun labarai  duk da ina jimawa kafin in karanta labaran bbc news duk lokacin da nake neman cikakkun labari masu kai da gindi nakan ziyarci shafin labari na bbc domin samun karin haske game da abinda nake karatanwa	positive
while you are busy shouting atikulate your grandfather is here praising a government that pays his entitlement  by baba	negative
ahh wannan sai ku tambayi nasiru zango	neutral
kadangare kan kuka	neutral
ydg daura photo ko rubutu a internet zai iya shafar rayuwar masu shawar siyasa she dace ta gane mutum nagari ko lalace ce 	neutral
shinkafa mai guba zaa raba mana 	negative
all that noise you were making about policies and reforms   this is where you end up   junior yahoo boy  the baba of all people	negative
allah yasa ayi posting enki maiduguri ko katsina ko zamfara tunda ynxu an koya muku yaqi 	positive
congratulations brother  muna tare	positive
ba wankiya bace aka masa rabon sune suka karba dan sunga ya kalmashe dayawa ne a videon nan farfesan dallar amurka mazauni kano	neutral
duk da an yi masa rigakafin kenan 	neutral
waike yaushe zaki gama tallanki ko kinaso ki ida samun kudin biyan bashin cameras ne	neutral
sadau film na mati azazzau ya na a rai ki to allah tabata da alkairi	positive
tom babu wanda yafi karfin allah ya jarrabesa allah said ask forgiveness of your loadindeedhe is ever a perpetual	positive
bazasu iya ramawa ba congratulations bmunich	positive
ke aisha matsalar ki kenan bulamas drawing ba ma halinda kasar mu take ciki ba	negative
dodar kawai a wannan zaben	positive
munagani munaji muna kuma sauraro	neutral
good  yayi kyau muna bayanka	positive
da shirinan yake	neutral
allah yasaka masa tausayin talakawansa	positive
for the first time in 45years we wake up without emir in zazzau  rest on bauna saniyar sake usumanu na zazzau allah yasa antashi a saa alfarmar annabisaw da alqurani	positive
naga mama daso tanayiwa kamta likin kudi 	neutral
abunda ya faru inec jua zai tabbatar muku da hakan 	neutral
wai shi wannan mai sankon waye neni yauma na taba ganin hegen da wani sanko nashi kamr single	negative
president buhari duk wanda yayyi mai kyau ya gani mai kyau yan najeriya sundauki yardarsu sunbakah allah kawomana zaman lafiya a najeriya ameen	positive
 allah yakai ki lapia mudai we are in nigeria	positive
wannan ai ko kaji arbain aka kashe sai hankalin mutun ya tashi balle ace mutane har arbain da uku  wayyo mun shiga uku a qasar nan ya allah ka kawo mana mafita daga cikin wannan masifu dasuka addabe mu	negative
allah na tareda kai baba uk finish putting sanction on nigera e no go work nigeria is not iran  nigeria is not america	positive
an sha foundation saura kawai a kawo blocks a fara gini 	neutral
sun gano duk karya ce 	negative
sarki wallahi ganinake man film yamaka tsufa yanzuinnaga kanarawa a cikin film wallahi harkunya nakeji 	neutral
cewa zakuyi an kama wasu daga cikin kidnappers kuma an masu yankan rago sai kuma wace tsiya dan an kashe yan iska marasa amfani irin su 	negative
sauro dan karami amma sai balai	negative
wanna somin tabinai ai kadan kuka gani	neutral
of course tunda ya karbi kason shi	neutral
wani bawan allah ne yanada gida na alfarma mai 5 bedrooms 2 parlours yanada mota mai ac kayan lefensa a shirye suke kamar set 70 kawai kudin sadaki zai bayar a daura masa aure allah ya karemu daga sharrinsa ameeen	positive
my dear distinguished twitter people i need this fine vans just help me rt kajifa	neutral
ina tunanin her excellency hajrabi fulani ta dinkawa 	positive
happy beautiful birthday queenallah yayi ma rayuwa albarka bigger you i pray more money in to your bank account allah ya qara daukaka da nisan kwana i love you	positive
mulki da ilimi babu jahilci aciki allah yajikansa darahama amin 	positive
ni zan zama shugaban nijeriya a zaben 2019 cewar gwamna fayose	positive
ku kunsan komai ai bukola 	neutral
so sad  wllh shuwagabanninmu na arewa basuda amfani tundaga matakin haha har zuwa gwamnatin tarayya	negative
allaah ya masa rahama allaah kuma ya datar da mu rahamarsa alfarmar annabi da alqurani ameen 	positive
insha allah negative zaa gani	negative
shifa elrufai kallon bagidaje yake ma ganduje bai san kar yake kallon sa ba 	negative
allah yasa haka itace mafi alheri kuma allah bashi lafiya aameen	positive
aikinka nakyau director allah ya temaka ubangiji ya yadda da kudirummu	positive
innllh winnillhirjun ya allah kabamu mafita akan wadannan musifu dasuke faruwa atsakanin junanmu da yan uwammu ya allah kakawoman karshen wannan taaddancin a arewacin nigeria bakidaya ya allah	positive
majiyar mu ta sanar da mu yanzu haka ana tattaunawa tsakanin bollywood director faruk kabir da rahama sadau akan yadda zasuyi aiki tare labari ya kara karfi bayan jarumar tasa hoton director din a status na instagram inda shima ya saka nata a nashi ya kara da hoton zuciya 	neutral
vaccine na insecurity da tsadar rayuwa shine matsalar nigerians ba corona 	negative
ni banga dalilin irin wanan labari ba da farko dai aisha matar buhari ce idan yan sanda sunkama maaikatan ta sai taje su dai dai ta ina ruwan mu ana kashe mana yan uwa tayi shuru mijinta yayi shuru dadin abun lahira ba lauya 	negative
nabi tallapi da gudu na tallapawa uban da yake tallapawa tallapin manfetur in akwai tallapin yan tallapin	negative
wannan kuma suta shafa 	neutral
yaushe zai kaddamar zuwa arewa muda zaben shi wasu da fin fun gajiyan shi hmm buhari jibril of sudan	negative
sai yanzu kasan haka da kasha wahala pique wuya koda magani babu dadi	negative
duk hanyar neman kudin shi ne	neutral
haha yau rahama is in trouble	negative
allah ka isarmuna zulum nekawai kesunmu	positive
wannan baby kinsha kyau naso ina kusa ai snap dani have a nice day	positive
marsala ma sai kun kori messi ma tukunna  hala madrid 	neutral
ke tsiyarki kenn washa baki retweet kwata kwata ko comment	negative
gaskiya hakan yayi kyau ina fatan su samu daidai tawa a tsakaninsu	positive
bbc is feminine please bbc zata kawo muku instead of zai kawo muku	neutral
allah kayimana magani	positive
bbc kuna renamana ajawali dayawa	negative
allah ya gafarta maka allah ya sa karshen wahalar kenan 	positive
allah ya shirya	positive
bari na koma gefe nayi shiruuuuu 	neutral
muna godiya mutanen kaduna	positive
better to give up kawai irin wannan wahala haka	negative
dama sayar da nigeria ya yi ya karbo kudin ya debi kason shi ya ba kananan firaunonin su raba mana kowa ya san kasar da zai koma da zama	negative
allah ya kiyaye mu da yaran mu da zuriyar mu gabadaya ameen 	positive
the previous one yafi kyau 	positive
wlh first time daya burgeni kenan	positive
hhhhh aibaima cika komaiba dama anfada mana dan liti mugune nan yadaga sphagetti taliya har yana kuka  ashe bakin ciki yakeyi munajin dadi	negative
bayin allah da suka mutu basuda yan uwane ko yan uwansu basa social media ne something is wrong fa 	neutral
ok so kuke kuci kudi da sunan patients knn wanna munafurci dayawa yake	negative
dan ba dan president ko vp cos ko wani gov ko wani minister shiyasa iskancine kawai bakomai ba allah ya isa	negative
mtsw aikin banza aji da na yanxu ma da ake kashewa mtsw 	negative
nigeria is on the brink text of the nation press conference daga hukumar pdp	neutral
black maria shiga ba biya sauka da allah ya isa 	negative
nawa ne balance cikin bank account din ki	neutral
kai mai yasa baka zauna a nigeria ba lokacin da baka da lafiyaa lokacin aso rock cewa akai babu sirinji ma	negative
pls dear sir dont make ur day unhappy because of some useless talking shi wanda ake xancen akansa yanzu haka qila yayi bacci amma kai sunzo suna damuwarka pls help your fans and leave it as memory  we all support you sir	negative
kinsan allah ahaka kinfikyau you look so beautifully 	positive
keeee matin nan yaci uwatar kin ishemu hakka 	negative
wallahi wannan ba adalci bane ga babban matsalanmu nan rashin tsaro kuma kuma son kashi mutanin da yinwa zamuji ko da bandits 	negative
to wannan yanki namu na arewa sai a hankaliallah ka kawo mana sauƙiastagfirullahastagfirullahastagfirullah	positive
yaro ya tsinci hakori	neutral
 trump yasha wuya kenan wannan izinace ga shugabanni masu bakin hali susani cewa damar ahannun talaka take	negative
innaa lillahi wa innaa ilaihi rajiun a daidai lokacin da yan uwa a palestine ke cikin balai da musiba saudi ta yi shiru not even a word amma gurin shan shisha ke gaban bin salman  allah ya isa	negative
albert einstein once said  only a life lived in the service to others is worth living wannan gaskiya ne	positive
jiya ko yau 	neutral
guy dinnan ba zai daina raina muna hankali ba ko 	negative
nayi tambaya but shiru nayi miki uzuri 	neutral
muma muna godia sosai malam allah yakaimu lokacin malam muma we love you all  up saira movies	positive
kun dau dangana kenan mutanen paris	neutral
ya allah kakawo mana qarshen matsalar tsalar rashin tsaro a gida nigeria  baki dhaya 	positive
idan ba kinfi 25yrs ba hege nake kuutji fah sisters dinki ina mah lefin 35 haba aunty 	negative
is now baba jibrin verses baba atiku we shall see	negative
ki turo mana ita a nan niger 	neutral
shehi mufti menk zan zaba	positive
allah shi saukeka lfy daddy 	positive
akwai yan taadda a cikinta	negative
ya allah kasa mufi karfin zukatanmu 	positive
zanxo koh a big naki ne a saka ni mu tafi tare 	neutral
i swear zahra made the right decision by dumping this man  whaaaat wallahi aji tsoron allah dai	positive
duk dokar daza susa susa amma talaka yana cikin wani hali har yanzu basa maganar ya talakawa suke kwana saidai ya zaa kara matse talaka  wama tashauna illa an yasha allahu rabbul alamin da allah muka dogara	positive
 allah ya ba wa baba lafiya corona kuma	positive
innalilahi wainna ilaihi rajiun gaskiya yanzudai kam nayarda wannan tsohon ba kaunar talakawa yakeba ba kaunar cigaban nigeria yakeba subahanallah gaskiya nayi danasanin zabarka 	negative
dumame asannan abishi da shayi banda 	neutral
alkur an kinfi haka nima yaro dani am 27 bareke happy birthday and i wish u more years ahead	positive
suruka ta kenan eid mubarak 	positive
alhamdulillah wannan shine abunda aka kapa kungiya don shi	neutral
your mama kwantiri na 	neutral
dear queens  imagine waking up one faithful morning and you find yourself on buhari s bed  wrapped in baba s arms  just imagin	neutral
allah sarki babu yan gidan malam shehu	positive
babu abinda zasu koya musu daya wuce cin hanci da tashawa wlh babu wata kwarewa a dansandan nigeria  da har zai horar da na wata kasa allah ya kyauta	negative
bawata matsala management din barca sune suka kashemu	negative
 dama na fada ai zidane ze haska yau	neutral
gaskiya mahmud bai kamata ya mayar da halaccin da sumayya tayi mashi da haka ba amma ita yal banzar ta samu wanda ke sonta tsakani da allah da yadda shi shys naji dadin abinda mahmud yayi mata allah ya basu zaman lafiya shida laila ita kuma allah ya bata lafiya next episode	positive
saboda bazasu its sayen sa bane up  chelsea	neutral
allah yataimaka queen	positive
sai yanzu kikasan da hakan kenan  nengi fa	neutral
na gaida yar minister 	positive
gaskiya el rufai yafi buhari mugunta 	negative
allah ya bashi ikon gyara kuraransa kafin ya sauka	positive
allah ya bamu mu bayar 	positive
wooo zaidu allah ya ida nufi nakane	positive
kunason lalata mu fah da wannan direct kalmomin nan naku	negative
hmm ai bamu da wata hanyar da muke kai kukan mu wajan su sai ta nan to in suka rufe ai kaga sai ai ta kashe mu 	negative
wait kunce ta duniya toh duniyar baqaqe kadai kenan kuke nufi 	neutral
inna lillahi wa inna ilaihi rajiun dalilin me tunda mu dai ba mu san dalili ba lpyr mu qlau muna kuma godiya ga allah oh allah ga mu gare ka wahalar lock down ɗin nan za a maida mu 	positive
ameen sumo ameen when are we coming for shan ruwa 	positive
na rantse da allah baxan taba yafewa ba	negative
meanwhile our governor lolo is busy dancing with yanmata a wajen party allah ya saka muna	positive
keyamo  in terms of managing public institutions  alhaji atiku was a colossal failure sahara reporters fkeyamo atiku	neutral
wata kila idan yacika 419 zai daina	neutral
muma ba a barmu baya ba	neutral
muda muke yan arsenal har a gaya mana muyi hakuri 	neutral
nice initiative yayi kyau	positive
allah yataimaka ya bada lada wayanda suke son suyi kumerh basu samu sunyi hakanba allah ya basu yakuma sa muna daga cikin wayanda zaa yan ta acikin watanan mai albrka ameen	positive
amma dai bbc kun iya sharara qarya astana din da ta kama tayi ta lugudensu har aka tashi zaku ce wai tasha dakyar wanda yayi wannan post din duk a gamata dan arsenal ne	negative
wahala dey for our country 	negative
shi presdo yana dan over acting shiyasa amma dashi zan zaba akan mahmud mahmud yacika kwafsawa amma shima ba laifinshi bane laifin waccan sarkin nacin ne 	neutral
sakamakon lockdown nayi budabaki da pepsi da pure water 	negative
wllh excellency yaci mtuncin masu yin takarar gwamna	negative
kaiiii yahudawa suna ta siri sai kace malaman hadith sai wani tayar da jijiyar wuya ake akan wani dan iskan film  got is just semi porn	negative
sun gaji da bada 33k din kenan	neutral
my favorite song alkawarin mu na nan	positive
if atiku can lie about his upbringing tell me he will not lie to nigerians   allah gamu gareka ka	negative
wannan magana hakatake	positive
is this a selfie kinyi kyau ba karya 	positive
shegiyar qarya kawai	negative
ance min kina lagos shekaran jiya ma kin zo area na shooting yaushe zaki dawo dan allah we have a lot to talk abt 	positive
allah yabiya sarki sunusi	positive
barka da shan ruwa from archive 	positive
kunji shigar raboh koh	neutral
vip kin hadu fa	positive
barka da sallah sir 	positive
allahu akbar allah ya jikansa da rahamarsa allah ya yafe masa kurakuransa summa ameen 	positive
gaskiya akoy aiki next season 	neutral
ameen allah ya masa rahama	positive
maybe ganduje yasa mu ko 10bn ce idan anciyo	neutral
sai ankashe rayukan kaji	negative
allah ya qara lfya muma muna taya kanmu murna cika shekara 14 muna azumi 30 na ramadan duk wata	positive
bbc yau baku samu news ba ke nan	neutral
atiku yayi ikirarin cewa hatta alikodangote sai da tarin talauci dake karlashin mulkin mbuhari ya shafe shi	negative
 nice on boo kin fi yan hassada mayu	positive
a bashi sandar mutuwa mana munafukan banza	negative
mukan karan kasa ma muna allah wadai da shi	negative
aikin banza kawai ba wannan muke bukata ba 	negative
ke muta ne suna kyautar billions ke kina kyautar hundreds naira     idan kyautar zakiyi kisa mutane su drop din account dinsu kitura musu wasu yan canji	negative
kun iya bada labari 	positive
exactly malam but son duniya ya hana su gane gaskiyaidan mutum yayi magana sai ace ya raina shugabaamma now is high time for them to understandbecause we will not ster silent againsecurenorth 	negative
congrats wo sai munzo sha	positive
mai rusau is going along with the almajiri which is interesting	positive
ameeen summa ameeen director ya labarin firlm din mu neh labarinayaushe za a cigaba da nunah manah	positive
wallahi kar wanda ya kuskura a bashi raigakafin korona billahillazi domin wannan maganin akwai wani masifaffafen asit a cikinsa not in we dont need it	negative
kai wannan ko mashiririci daman akwai wani abu dazai faru ba bisa dalili ba 	negative
allah ya kara daukaka princess 	positive
waga duniya  allah yasa mutashi daga cikinta lafiya zamani kenan 	positive
subhanallah   allah ya qara kare musulunci da musulmai	positive
nigeria  tura takai bango nigerian army riot boko haram in sambisa forest	negative
a gani a kasa ba fda a bake nima xa eya cewa ba wanda y esa y taba ni en dai wanan maganar ci baba kowana banxa a gare xai eya buga gerji y fda  shekara nawa ana mgna 1 mu gaji da eri mganar nn muga change da k ki mgna 	neutral
wonderful amma dai a nono suka shaka ko don munji likitoci nace in uwa ta cin ƴaƴan ka iya sha a nono	neutral
bafa tashin duniya baneeid ne	neutral
wannan wani irin mulki ne dan allah sai kace akasar mahaukata	negative
amarya bakya laifi ko kin sheke dan masu gida 	positive
wai tsit kakeji uwar gulma tayi ciki up england	negative
yan xu shi kenan anje hutu  malan saira gaskiya toh kudawo da wuri	neutral
please yaushe zaa tattauna dani 	neutral
allah ya kyauta wai a aikata mugun laifi irin wannanamma wai abun haushi abin takaici abun ciwo ake kuma neman sulhu da wanda ya aikata laifinkuma abun kona rai shine laifin ya tafi a banza allah ka bamu zaman lafiyaka kare mu ka yaye wa bayin ka amin 	positive
ina jin dadin yanda bbc ke rairai news kamar ana waqa 	positive
ga kyau ga lasting 	positive
wlh har nayi mafarki wai kin cikin house mates na bbnaija 	neutral
hakorin dariya shike tauna kashi	neutral
finally bayan laukar cikin wata tara asuu tah haehu sae avun 2nanin anan shine wayasan namiji tahaepa ko mace	neutral
allah y jikanshi da rahama	positive
niha rahma so nake ayishi dan nadade inasanki aradu	positive
yau yasa maks k nan	neutral
kaga kama karyako  bayansu babu wanda yakamasu sanda sukayiwa gomnatin baya  allah yakawomana daukin wannan zudda jinin da akeyi a yankunanmu na arewa 	positive
vaccine za ayi musu 	neutral
ni kam ina uar dama	neutral
wannan wasan yarane ace yannigeria zasuyi rigister a sati biyukasar da take da mutum samada 200m 	neutral
inaa bayan alinuhu education is better than money 	positive
allah ya sakama wlh ba zamu taɓa yafe miki ba kin cucemu kin zalin cemu wacce ta san abinda take ba kina yar musulmi kina irin wan posting ga shinan ki jawo mana ai	negative
yan wahala akwai allah yai mana maganin ko 	positive
na dauka ma kudin sadakin ne ma 	neutral
allah ya kara rupa mana asiri allah ya karemu daga sharrin masu sharri	positive
mashaallah allah yasa mai amfani nine 	positive
ok now  let me see how you will get restructuring with or without atiku anya ko	negative
sunan wani gari wai yar zabuwa 	neutral
allah ya tsinemuki albarka wlh ke annoba ce cikin addinin islama  kowa la antarki yake a gari wlh anyi asarar haihuwarki	negative
diidii dasu naga ana shigar da maikano sabuwa house 	neutral
home training na tauye mu da yawa a wurin nan wllahi 	neutral
hhh kuma abun haushi ana kiran sallah kinashan ruwa kawai ma xakiji like xaki iya cigaba d axumin ma	negative
allah yakawomana sauki cikin gagawa allah muntuba 	positive
sai kuje villa ku tambaya	neutral
2000 kachal mtswww kadan ma ya gani sai ranar kiyama ya ga shedan yana masa thumbs up  ze gane nafila ce wahalar hannun soja	negative
ko banza dai covid19 ta hana clubing da sauran aikin banza	negative
baba buhari ya tafi daura dan yin zaben shugaban kasa	neutral
iskanci kenan ko me	negative
allah yarabamu da gwamnatin ayan wariyar launin fata 	positive
nothing but fact  allah ya bamu zaman lafiya ah nigeria 	positive
meyasa bakada imani ne wai kai wanann buhari  such a heartless person	negative
kaga masu da gaske ba kamar oo ba 	neutral
allah isa kuma duk mai hannu acikin wannan kashekashen ya allah kai mishi yanda kaga dama	negative
dogo kowa ya zabeka bai zama lallai yasha jar miya ba 	neutral
tab am ma wannan gardin jahili ne  am sure he has a brain disorder	negative
allah ya daukaka tv arewa24   	positive
bbc ku iya ma bakinku fa	neutral
wai dan allah a ina na kano yake ne	neutral
nothing beats and ifthar with a flavored maltinaandabove all sharing with family  barkanmu da shan ruwa ifthar mubarouk 	positive
abun farin chikina a 2020 ina matukar fariciki a shekaran nan saboda a 2020 na samu kudi inason shekarar	positive
mai abaya  mai abaya  mai abaya  a kara dani nima please	neutral
allah yakarama sarki lfy da nisan kwana 	positive
 indai caption ne asami bbchausa	neutral
who told inec i  m at fct hahaha su suka ganoka	negative
to ai ba laifi bane domin duk wanda ya kona rumbun shi yasan inda toka take tsada 	neutral
wannan gaskiya ne haka yeke tabbas allah ya kyauta	positive
hmm anatayi munataji	neutral
allah ya cigabada da tona asirin su ai suna dayawa	positive
ya allah kasa abincinmu a inuwa albarkacin annabi muhammad saw	positive
to meye amfanin zaben ma	neutral
the apc should be ashamed that they relied on underaged almajiri votes	negative
dan uwarsu sai da lokacin mu yaxo za a soke wannan shine matsalar spill over 	negative
don t cause trouble in ekiti  osun  pdp cautions inec siyasar bana	neutral
kaji wata tambayar rainin wayo saboda yanaso su zama yan boko haram 	negative
ada na xata girman kai ne da ita amma yanxu na fahimci ba hakan bane please forgive rahma 	positive
yooo ae dan lanjeria da corona kamar dan juma ne da dan jummai dan mu tun kafin corona tazo muke da ita 	neutral
estás listo rahama if yes then ina kusa 	neutral
allah baya barin bawa ba aikin yi	positive
tirkashi kasuwar madamfara zata mutu	negative
kaji rainin hankali 	negative
anya ys dace kuwa 	neutral
idan har zai kula da su idan ya hana su bara to zai yi amma idan ba haka ba to gaskia ya taro match 	neutral
allah sarki talaka  ba wan allah allah kashuge mn gaba 	positive
one week later let s see what happen insha allah	neutral
ba fada muke ba wayarwa da juna kai muke we can do better please	positive
hahahahha you guys are funny haka sukace muku sunan maganin tazargada	neutral
wtf even is this timeline baba de	neutral
mashaallah allah yasa kafita kunyar mu	positive
oga director ba sai ka biya ni ba a kaini umrah in sauka a 5star hotel sannan in huta a dubai abu dhabi kafin in dawo kano godiya nake zan turo resume 	positive
baba we are no more as blind as 2015   we thought we had vision but out vision deceived us	negative
wayyo allah this yarinya akwai beautiful over	positive
kaga maza da kayan mata mai keta sararin samaniya domin duba barnar ambaliya sabida tsaro minister kakeji	neutral
ahh half zan yarda an rage hanya ai 	neutral
when did we start collecting receipts for corrupt deals   ikon allah	negative
happy birthday hajiya binta bula 	positive
badai barayinshanuoba awoi wata akasa wlh mutum 100kuma duok barayi ok toh shanu nawa zasuo satane 	negative
hhh mutumna kunsha saura mu	neutral
dg apco  otunba gbenga daniel  british high commissioner to nigeria  archbishop of canterbury duk suna nana	neutral
kai ammafa itama harijace mtum sha biyu kuma two months	neutral
se kace wata kunama	neutral
allah ya dawo dashi daidai	positive
kuma dutsen ya dahu	neutral
aa tana yawon buɗe ido ne 	neutral
tho allah yai mana tsari dasu 	positive
wannan labarin karya ne kaje kuduba instagram page kuga a culb ma ya kwana  ko dayake naija ce wata kila cunsakeshi	negative
aisu shuwagaban nin sun san yadda aka sacesuta inda aka hau ta nan za sauko	neutral
kana ruwa brother 	negative
haka zalika matan kudu sunfi matan arewa iya soyayya 	neutral
ba kyau karya dallah u dinno answer everybady	neutral
saboda kaza bayan hana ayan kata	neutral
yan nanaye seh a mutu	negative
corona loosing ta kama mutanen 	negative
muna godiya uban abbah	positive
who just received inec 2019s text nifa na gaji da text dinnan	positive
ya rungumi kaddara ya ba buharin amurka dama shima ya dama	neutral
kai wannan dai sedai anesa kuwa 	neutral
ai kuwa sun kare martabar jamiar su badan wannan sanarwa ba da mu baje degree a wannan jamia 	neutral
kayi dai dai dattijo 	positive
wai malam abduljabbarkuce tantiri abduljabbar	negative
cikakkun bayi a majilisar mu ta twitter	neutral
wato an manta da mutuwa ma	negative
subhanallah allah mun tuba ya allah karka kamamu da laifin da wasu wawayen cikinmu suka akata 	positive
hmm sai magana kuke ko mafitar aure baiwa dubawa akan wanna protest din al ummar arewa muna ta kukan amma ko kula mu bakwai yi allah wadai 	negative
allah yasa shi yasi xama alkairi gare ka	positive
amma kuma mai lalata tarbiya da watsa ingancin macen aure ne	negative
masha allah yakara wuce masa gaba	positive
baba has now become why baba	negative
wannan aika aikan shine zai yi dalilin kawo karshen boko haram insha allah allah ya jikan wanda suka rasu 	positive
allah wadaran naka ya lalace wai yanxun abun takaici ne ma ace wannan magana tana fitowa daga bakin musulmanmu wai ace ana roqon bawa da ya yafewa wanda yayi 6atanci ga ga allah da manzon sa to taya qasa zata zauna lafiya anyi jifa da shariar allah an kama constitution 	negative
 what bakin gida	neutral
mutanen banza kawai marasa kinshin talakawa insha allahuallahu b zai barku ba albarkacin wanan wata mai alfarma 	negative
na gayamiki gaskiyar wanda zaki turawa da account number dinki inde kudi kike bukata zaki samu babu batin cewa se anjima ko babu network gaskiya ki turawa da kin santa jarumar nan  to baki da matsala idan kina da itama to ta kare 	positive
allah barminku tareh 	positive
innaa lillahi wa innaa ilaihi rajiun a daidai lokacin da yan uwa a palestine ke cikin balai da musiba saudi ta yi shiru not even a word amma gurin shan shisha ke gaban bin salman  allah ya isa	negative
kwana nawane zai bar wajen gaba daya	neutral
ammn kamar really extra ne a hannunsa 	neutral
innalillahi wa inna ilaihirrajiun allah ubangiji ya gafarta masa yasa ya huta sukuma ga duniyar nan muzuba mugani ko zasu dawwama a cikinta 	positive
a haka kake cemin nabi never 	neutral
sai atiku	positive
mahmoud zai rasa 5 million naira da summaiya da kuma laila ita kuma summaiya za ta koma gurun lukaman 	neutral
mark it now  for buhari  i d do one free surgery every day for a month if and when buhari wins  inshaa allah jackobin	positive
 lanle yan minista	neutral
tabb mukan yan kallone	neutral
i turned on my tv to watch nigeria vp candidates debate and fell pregnant pregnant with questions dr damages baya kyalle kowa	negative
matasa sun gajine allah yayiwa kasar mu arziki amma wasu tsirari sun maidashi nagado an shiryawa talaka talauci akan tebir mun zabi buhari domin musamu saukin lamarin amma gara mulkin kowa ma danashi anata kashe mana yan uwa arewacin nigeria amma ko ajikinsa	negative
zamu je kuma zamu dawo insha allah idan yaga dama ya kwana a boarder idan kuma har zai tashi toh sai mun dawo gida mun kwana nonsense and ingredients 	negative
bbc wai da wani irin waya kuke tweeting 	neutral
muna fatan hakan dukda dama ai ba kowane keda madafun iko a nigeria ba fiyeda wannan mugun shugaba wato buhari mu talakawan arewa saidai mu cewa buhari allah yasa	negative
why nt sumayya	neutral
god next level is what we pray for pls take us there baba god pls	positive
uban da yafasa yaci uwarsa wanda ya fikama yayi ya gaji sbd addinin musulunci ba abin wasa bane dan uwarka	negative
likitoci ne suka fahimci idan ramos baiyi hutun daga champions  league ba akwai wata jijiya da zata bashi matsala shiyasa muka hakura	neutral
wallahi sai ka tara maza dubu duk kanin su in suka sami irin damar da muhamud ya samu sai sun yi amfani da ita kuma ita ma sumayya ai dan dai a film ne da tuni ta watsar da shi ta dauki masu kudin baya musamman ma lukman	neutral
da giveaway kodai irin wadda ka saba	neutral
i like alhaji kwankwaso   he is a performer   but he hasn  t got the clout to deliver the presidency to the apc and neither does atiku	negative
wallahi kar wanda ya kuskura a bashi raigakafin korona billahillazi domin wannan maganin akwai wani masifaffafen asit a cikinsa not in we dont need it	negative
 but ban taba ganin falalu na rawa ko waka ba he is a gifted and talented director sai kuma yena fita a wasu films din yenzu	positive
allah ya isa na kallah abu abanza datana yatafi abanza mtswww	negative
you are talent allah yakara basira 	positive
 china china wannan ba gaskiya bane kawai da batune irin na yankin asia ma abota uzzurawa yan jarida da tauyewa jawaba fadin albarkacin bakinsu	negative
anyi walkiya kinga kowa dan allah kikiyaye allah ya tsare nagaba 	positive
with a savage reply inada data da kuma full battery 	neutral
jigawa kuna ruwa 	negative
ke abida baki mun wanke wanke ba kika fito yar minster is soo lit   	neutral
wow nadade ina jiranki kifadamin wannan kalmar saura kuma naga suna a first list din court	neutral
ai tsinannene kawai zai zabi apc 	negative
app 21billion kenan xaa kara sace su kenan ko suma asama ina suke wuta 	negative
ya allah its part of her destiny allah ya raba mu da mummunan kadddara ameen	positive
ni abinda ke faruwa a nigeria yafara isata kullum cikin matsaloli ake kullum abu daya yakici yaki cinyewa allah shi wadaran shugaba mai kunnen kashi bansan amfanin mulkin buhariba har yau wallahi wlh gwara mulkin na wata 3 da mulkinnan na shekara 59	negative
allah ka tsinewa ganduje ka tsinewa duk wani da yakeda hannu da duk wani dayaji dadin cire sarki da duk wani dayaji haushi domin na tsinewa ganduje shege dan karya  allah ka yada cutar corona virus a gidan gwamnatin jihar kano da kano state house of assembly	negative
mbuhari using abiola s name to gain political capital   cewar jamiyar pdp officialpdpnig	negative
hhh bari ayi sama da first born dinta  lokacin zata bari afadi gaskiya 	negative
rahama i miss u ina kika boyene	positive
mun sani baba 	neutral
toh shikenan amma kasan dino ya iya acting sosai kamar ma yafi kwankwaso 	positive
wannan mutumi ko dan iska	negative
haba wai mutane sun koma kamar dabbobi suma kamar gargin tumaki ne da za a re na ma na wayo wai sata ita gwannatin wai ita an fita wayo ne abin tambaya anfi gwannati wayo wlh allah sai ya tambebaku domin mu amana ce mu a gareku wlh zaku amsa tambaya	negative
do you believe baba baba when he said everything was done to save the red cross worker  hauwa	neutral
sbd sun hadu da zummuwa uwar halbi	negative
tayi mata ciwo kenan 	negative
wai shin arewa 24 bashi da tsarinda za a iya kallon shirin ta kai tsaye ta waya 	negative
muna fatan allah yakarbi adduoinmu baki dai allah yazaunar da kasashen mu lafiya dan darajar annabi saw 	positive
ya allah ka karemu daga wanna matsalolin virus dinnan amin	positive
alhmdllh allah mun gode maka da kabamu governor nasiru elrufae naziru sarkin waka dama ya yayiwa gwamna waka mai taken malan nasir elrufae guduma mai fasa karya shukran likulli mustamueen	positive
and parasitic moronic simpleton such a baba atiku is talking about elections   god must punish him and his onenigeria	negative
a whole lot of people prefer to watch arsenal vs chelsea match than to watch the nigerian presidential debate wa zai zabi kallan bakin ciki	negative
yawshe mukace haka wallahi bamu damu ba 	neutral
lallai ammar wanka hardana aljihu fafalolo	positive
wannan attach haka kmr bakya sallah kodae kina abinne	neutral
muna muna alfahari dakai sairamuch	positive
mtwsss sun zo duk sun hada mana holdup a gari apc zancen banza	negative
moms na duku tsohon ciniki kowa yazoshi dunia kai ya tarar	positive
an dade ana haka a bai taba yin magana ba	neutral
ya allah ka kawomana dauki munaciki damuwa	positive
kina bata girma kike ce mata aisha babu cewa mama ko wata kalma da zata nuna cewa kuna ganin girman nagaba daku duk yanda akai shima boss baya samun girmamawa kawai gobe da nisanku shine yake aiki hausawa sunce dole ace da mijin iya baba 	negative
igwehifeanyi apcnigeria atiku that s what he said  but corruption is not the only problem we are having as country tayani gani dai	neutral
duk wan nn d sauki indae xa a koh m university ae shikenn sbd rashin kudi y kusa karar dmu secondary damn basu sn ddn koh mae bh 	neutral
dama zaria tana cikin katsina neh kaga sai el rufai ya zama governor zaria not kaduna state 	neutral
akoi kalubale a harkar abota sakanin maza domin wani ka dauke sa abokin ka na hakika kuma daga karshe yaci amanar ka babu dadi	negative
kakawo mana video inkunaso muyadda da kuma hotunan gawar domin wanan shine karo kusan na 33 da ake cewa shekau ya mutu alhalin yana raye	negative
these people are just calling numbers and am poor in statistics mbuhari bari na koma aji yanzun	negative
happy birthday may the rahamallahu taallah be with you my favorite actress but akwanakin baya kindan kwapsa mani kadan for your trending dressing issues on social media dun allah ki kula sosai	positive
sae ka tsaya ka saurari daka 	neutral
ni ko kadan hakan bai bani mamaki ba domin kuwa vazu dauki rayukan yankin arewa a baki komai ba hakan ya kara tabbatar mana da mulkin kama karya ake yi mana allah ya kaimu lokacin zabe maga shegen da zai zo mana arewa campaign 	negative
kunfi kowa iya hege ai a social media ai 	negative
indae kanajin yunwa kada ka gwada wlh faduwa zakayi na person wey chop belly full go fit try dis mallam	neutral
su koma bautar allah insha allah zasu samu waraka	positive
yayi matukar kyau wlh so na ma ahana a zaria wlh yin hakanzai burgeni matuka 	positive
 rahama sadau on love fire	positive
mukam alhamdulillah da sauki a garin abuja	positive
hope wannan guy din bai min kapa ba abin naki dear harda yaudara kuma inada kishi pa on u anything can happen 	negative
warning ne ake yima buhari	neutral
wayyo kudin mu	negative
no bakuyi kuskurebashe has very nice beautiful gyal	positive
innalillahi wainna ilayhi rajiun allah yataimake wannan matar dan darajar annabi muhammadu sallallahu alayhi wasallam 	positive
sarauniya hausathe queen  of hausa movie	positive
haka yake iyaye abin alfahari allah ya rabamudasu lpy allah bamu abinda zamubasu	positive
allah kadai yasan abin da zai faru	neutral
yajii kin mallam akan dukan dayasha yau a airport	neutral
allah yabaki lafya mamana yasa kaffarece agareki i really felt that which youre going through may allah grant you quick recovery aameen	positive
baku da kirki	negative
dan sanda abukin kowa dan sanda ko yayanka ne inkaiyi laifi sai yakamaka idan shi bai kamakaba toh sai yasa wani yakamaka 	neutral
wai dankali kike nufi 	neutral
dis kyau no get part2 rahma 	positive
bbc hausa nakasa yadda da wannan shirmen kodai kunhadu da sharrin yan kutsen naura me kwakwalwane wannan ai xalan akuyanci ne ku sauke wannan post din cin xarapine ga mutanen najeriya	negative
a hi kunya dai wai budurwa	neutral
retweet and dan najeriya ne ya lashe gasar cin abinci mai masifar yaji a kasar china congratulations dan mayya 	positive
ace mata ina santa santa	neutral
hhhhh inconclusive ta tabbata 	negative
abin taikaicin dalilin abinda kika saka wani ya gayawa allah magana wani ma aiki ya gayawa innalillahi wa inna ilaihi raji un kuma kinyi shiru baki karesu ba ya allah ban taba jin na tsani wani kamar yadda na tsane ki allah ya isa bamu yafe ba	negative
meyasa baa nuna a arewa ba plzzz	neutral
mene yasa wai buhari bazai rabawa talakawan nigeria  tallafi bah	neutral
wannan wasa yayi matukar kyau sosai	positive
gerraut abunda yakai sati sai yau kuke posting 	negative
your threat is empty   edo youths tell nass the edo youth volunteers for progress  eyvp  has cautioned the national assembly siyasar bana	negative
kurunkusazo gurin bahaushe yace girma ya fadi wai rakumi ya shanye ruwan yan tsaki dan allah bbc ku goge wannan labarin tun kafin aljanu na su tashi	negative
lafiya kalau sir ya hanya kuma allah ya sauke ku lafia muna saurare dai 	positive
a matsayin na wa kenan oh ashe fa itama public figure ce  	neutral
allah ya bamu zaman lapia a wannan kasa tamu ta da kuma arziki me dorewa mae albarka	positive
come one come all we are almajiri for life and so what	negative
easy mana bbc meye wani matsuguni kuma 	neutral
yar lele nah ina so nasamu aikin sss domin duk inda kike sai na naimoki domin kawai na taba haduwa dake 	positive
aunty kisha shagalinki 	positive
wai tace ya kwantar da 	neutral
gaskiya zanen batanci ga annabi saw abin cin rai ne amma ubangiji allah na gani kuma zayyi wa kowa hisabi	negative
ai kowa yasan inda suka tafi suna cikin babbar riga ai 	neutral
hmmm ai ga wajenan 	neutral
bandicts jiya ma da daddare sunshiga garin dan kaya dake sheme ward sunkashe mutum ukku aciki harda jaririsun kwashi dukiya sun ware abunsu kamar yadda suka sababayannan suntafi qauyen unguwar hayaqi nan ma sun kwashi dukiya suntafi hankalin su a kwance	negative
basu iyawa period 	neutral
nijeiya ta buhari ce sai baba	positive
hakika duk wanda yayi kuskure kuma yayi nadamar abinda yayi to allahu gafurul rahim allah ya mana gafara baki daya amin 	positive
allah yasa halinsu ba daya ba in ba haka ba amurkawa sun shige su	neutral
duk randa akaci babu nigeria duniya da tayi missing din makaryata yasin	negative
komin waye wanka kana shi gowa zamu ganeka haka kuma muna shiga garin wasu saikaji sunacewa daga kaduna yake wlly 	neutral
aikin banxa kenan tunda ana yankewa ma aikata salary 	negative
rabu da yan kutumar uba	negative
a 2014 kuna kawo mana update na kwanaki da awanni da mintuna da yan makarantar chibok sukayi wannan lokacin mun jiku shiru ko laifin ba iri daya bane 	neutral
tho taska muna bakin tv 	neutral
tohallah ya yaye masu wan nan balai amin	positive
kuzo kukai kudin gaisuwa 	neutral
ina sha awar shiga amma ina benue state ne inkunni meni xan iyazuwa	neutral
ga bakiii kaman horse  na shan kunu fuskaaa fun anbiii a dubulbulashi da foundation 	negative
shikuma na shan ruwane ko	neutral
goodhaka muke so yan man united ayi hakure sai next level	positive
rariya the blockbuster in kannywood boxoffice insha allah	positive
duk abinda zaayi ay a qasarnan babu abinda ya damemu tunda duk basu damu damuba nan gaba sae anzo ana siarwa turawa mu daya bayan daya	negative
kawae dae kaman baba buhari north suka fi bashi votes amma south suka fi morar govt ensa simple	negative
ya naga sunci kaftan ne  	neutral
allah ya kawo mana karshen wannan masifa  alfarmar sayyidina muhammad s a w 	positive
face mask tasamu gurin zama chap chap 	neutral
saboda anci manchester ko duk damemu da wani posting 	negative
ai gara da ya soke su	negative
wa zai zama angon nijeriya bayan zaben 2019	neutral
allah subhanahu wataala yatayashi riqo 	positive
allah y biyasu y saka masu da alkhairi	positive
yau da gobe kawai shawara daya ce ayi abandon na jamioi masu zaman kansu a nigeria kamun nan na gwomnati ta inganta allah yasa 	positive
inji wanne shege 	negative
babu abinda yake damuna da buhari watarana idan natuna yadda zaamasa hisabi akan hakkin alumma dayake kansa kuma yakasa komai  sorry buhari	neutral
barka da arziki our one and only binta kutigi 	positive
suce office din yah kara konewa koh ah ce muchiji yah hadiye kudin	negative
lokacin da taje karbar takardar shidar tayi de inde ba kannywood ne ppa dinta ba	neutral
9ja baabiyaka dai kamutu balantana anbiya ka nidama zasu a mince da zanyimusu uku 100k harda discount saina basu	negative
coronavirus kwararrun likitoci sun yi wa kano tsinke 	neutral
yahaya bello carry go ja muje zuwa	positive
zamu tuna shida wakar natsaya ga annbi muhammad saw	neutral
because of my love to your life style am changing my handle name to saudaus fan right now ki cigaba da ruta mukuma zamu cigaba da binki da petir ranki shidade	positive
daracta a duba min mai kishi haka	neutral
allah de nagannsu kowa seya answer query wllhi xakuma allah bayanin kashe bayin allah da ake sheguu marar sa imanii	negative
ayya baby baza mu taba rabuwa ba 	positive
bata kawo farin kai	neutral
albarkacin baki allah yabaka nasarar yaki da maƙiya	positive
karyar banza zakara  ya taka huka 	negative
subhanallah ya allah ka kawo mana karshen wadannan masifuastaghfirullah waatubu ilaik	positive
abun tausayi a dageh young doctors	neutral
kin bata ma duk wani musulmi mumini rai wlh allahka ya femana laifukanmu gabadaya kema idan har zuciyarkine allah yayafemiki allah yashiryemu allah yakawo mu karshen duniya wlh allah ka kashemu da imaninmu ya allah	positive
 wanan maganar shauki ne takeyi ai kudi abokan tafiya ne saboda gasu sunsa mahmud yabi	positive
allah ya karemu daga wannan cotar ta corona virus 	positive
what happened was awful  but always m prayers for her is that may this clip saga be d reason for her repentance from all sorts of awful things kowa pa nada nasa kashin a muriyan shi allah swt ya qara shiryamu ya rabamu da machiya amana ya kyautata karshen mu amen	positive
sai kace a indian hausa	neutral
  kubani kidan general a sama masu gudu su gudu  mugun a cikin muko a kasa  mun shiga next leven wannan tsoho wllhi ya samu matsalar kwakwalwa yarabawa sune mutane a wurinsa amman bahaushe shine dan iskan me son maso wani	negative
mitumina yacr na bugey da guduman nan gwam	negative
allah kaamsa mana allah muntuba badan halayan muba allah karka kamamu dalefin wawayen cikinmu yah allah kadubemu daidon rahama badan halin muba	positive
idan baka ceto su ba me za a maka	neutral
am sorry sis jinake kamar na tayaku kuku	positive
nidai banyi afuwa ba sai baba yaganni	neutral
masha allah gaskia kam akwai kalubale allah yaqara basira	positive
to bbc yan bakin ciki munci 20 sai kuyi ta indiyawa margaya sala	negative
wish her happy born day dear allah ya kara shekaru masu albarka 	positive
akalla lafiya sarki	positive
allah yakara girma yasa kayi governors jahar kano 	positive
ci uwarsu babah 	negative
duk abunda kafirae dinan sukayi qaryata ayar qurani da hadisai da kuma xagin musulunci da annabi da sukayi to kisan ke allah zai kama da laifi don kece mufari	negative
karka bige birin kano azumi nereally miss tashe	positive
gaskiyane allah yakara daukakaku daga naku mai sauraronku harkullum 	positive
wayyo aunty rahama allah yasa kifi haaka	positive
impossible kowa ya soki don ko ni bana son ki ehe	negative
kaga mutumin nan shi ta golf ma yake ya hayyu ya qayyoom karemu daga wannan rashi tsoron na kasa 	positive
ta ina zaa tuhume ni ina gombe  name hanyar jos sai dai ko	negative
wato ya zama strange abu a wurinta ma so sad	negative
gasky ni shawara ta itace yakamta a tsaya a dubba abawa tallkawa wandda sukka pi buqqata temakon ba aje aqqarawa mai shi ba ngd	positive
tohm ina ruwan mu 	neutral
innalillahi waina ilaihim rajiu  wannan ai so suke nan gaba a siyar da nigeria nan atiku yace zai siyar da nnpc amma a kai chi ai ni a ganina gara atiku wllh da yasiyar da nnpc din ai da min huta	negative
wasu yan arewa kenan jahilci ya mamaye zuqatanmushiyasa nasara bata zuwa mana yakamata a rika girmama celebrities kodan daukakar da allah yabasu amma mutane koda wasa basa girmamawa suna gani kamar gayan kowace kalan magana ga celerity wani burgewane	negative
wnn hk yake hajjaju 	positive
mai masoya da yawa  hello queen kindly inform us your fiance dannaga mutane da yawa suna go slow akanki	positive
dan sanda a nigeria dayawansu suna kwadayin talaka yayi laifi ne domin su kamashi su karbi chin hanci corruption yanda a traffic  ne zakaga ya tafi chen gaba amemakon ya tsaya waren aikinshi ya kula da aikin sai dai wai yaje yana jiran wani yakarya doka domin yasamu	negative
your excellency baba atiku   you adjudge a business as successful by it  s books   i challenge you to publish state of affairs office	negative
gaskiya akwai tantama a cikin wannan batun	neutral
ta shekara dubu shida a kabari bawai bbc yaushe kuka fara karya ne	negative
anayi munajin dadin	positive
ta dabo tumbin giwa	positive
a tabi din tasan muhimmancin jama a yes 	neutral
gaskiyane hagutakiya saimubi dama ni inajima saina riga messi yin murabus amma kafin nan bari inje in kalli yar minister kona rage asara 	neutral
bura ubah look ramatu the app is not a facebook akwai shegu kikula	negative
su bahari a wuta ma majalisar su daban ce 	negative
kudi ai sunxo ampara aiki	neutral
kawai a saka hukuncin kisa ga masu kidnapping domin wannan shine mafitar magance wannanatsalar ku taimaka wa talakkawa da dokar kisa akan masu kidnapping domin talakka kadai ne abin zaifi wahalarwa	negative
amso su akayi koh ceto su	neutral
daga duniya sai kaduna see una kind of party	neutral
masu iya mgn sunacewa idan dawa takika kunkuru ma saiya tserewa karenka andaiji kunya wlh wannan shine change din	negative
muna taya murnar samun mukami	positive
dama kwankwaso yace tare zasuyi retire a siyasa	neutral
allah ya karba yar uwa kuma anemi tuba da gafarar ubangiji	positive
wutar da ta zama qallah qallah sai sunga dama allah ya isa tsakaninmu daku 	negative
give me bab mbuhari s foreign account number  foreign house number and foreign company address	neutral
talakawa da kiran sallah 	neutral
shifa tsoron allah ya zuci yake ba a fili ba saboda haka jamaa kubar alfahari da baba akan yafi wani tsoron allah	positive
madalla allah ya taimake sojojin nigeria su kauda wannan fitinya amin	positive
atiku wins a pdp presidential ticket herdsmen stops killing farmers sounds like an already planned miracle to me sai buhari	positive
wai yaushe ni mallam retweet xaayi hira danine  domin masoyana shn qosa su ganni a arewa24	neutral
noma toshen arziki or noma rufin asiri	positive
a haka tenure din zata qare da karya har ku gama bazaku dauki kowa ba	negative
kowanne musulmi na bukatar addua ne idan har yayi ba daidai ba pls pray for her and ur advice should be in a right way without insults 	positive
wow rahama u luk vry beautiful allah y kara shiga lamarunki yarabaki da sharrin makiya	positive
happy jumaat kareem hajiyar allah kannywood super  proud of you	positive
 u told u earlier barca va club bace kinki ji gashi nan ta baki kunya	neutral
wajen talakawa ba wanda ga daki ga daki kaman kaji masu kudi kuwa ana zama zanzan kowa da flat din ta kowa da mai aikinsa kowa da motar sa kowa da direban sa ga kaji ga maggi 	neutral
kace tun lokacin da ake saku a roadblock kuna karban	neutral
kunyi tuping error ku gyara 	neutral
y zaai ina son ganin shirar can da kukai d sani zoro d alama gwamna zai 	neutral
tau ubangiji allah ya isar miki da isarsa kidaina wannan kukan kawai ki maida komai nakiga allah saboda shine kawai wanda zaibi miki hakkinki	positive
gobe kenan ko kuma 	neutral
allah shigafatta malam the chickens is already done am just kidding broskaida cinhanci yayi yamma kayi gabar said in the movie sir aci zabbi lafiya the movie showing on 12 june in ado bayaro hall dont miss it come together	positive
tunda anyi mati a zazzau muna jiran lado a kano shims	neutral
ba sauki a kebbi	negative
39 days to febaba and baba alhaji atiku spend wisely	neutral
masana ko mahaukata 	negative
naga be daku ba	neutral
rahama with her bangers	neutral
ya allah  ka karemu	positive
gaskiya dan allah kar abar sumayya ta walakanta kan wannan saurayin mai kwadayi mayaudari 	negative
abamu makamai dan kare kawu nan mu aga koh zamuji tsoron su manah maganan banza kawai	negative
ameen ya allah annabi yasan da xuwan sa	positive
da alaman su jagaban an fara tsoro 	neutral
abun haushi saboda pizza da shawarma sai a wuni ana yawo dake a mota kamar ragon layya da sunan chilling ba dai aji	negative
election is around the corner make sure you vote baba sai baba buhari	positive
toh fa toh yanxu wa kuke so mu tambya	neutral
whoever started this clone story of baba as jibril from sudan has a great gift of charlatanism	positive
gyada mai sihiri kabara kaga biyu ka murza kaga hudu kuma ka afa abaki kaji dadi	positive
allah ya nuna mana nagaba my best actres 	positive
kapin ka fita kasar waje ball se ka buga topa division 3 2 1 premier sannan nigerian league lokacin ka kusa shekara 35  agajiye suke zuwa ne yawanci	neutral
dan allah kar kuyi mana haka	positive
na tsaya ga annabi muhammad mamman shatas voice 	positive
kaiiii ya kamata muyi fa dube shi dan qarami dashi	neutral
qarya ne wlh ba kasar da takaiii china mutuwa 	negative
ask every political office aspirant what they will do to stop police brutality in nigeria baba moghalukingsley alhaji atiku	neutral
hello hajjaju kwana biu bna samun response dinki know dat i still love and support u dear	positive
bashi jali ya fara sanaa mtswwww 	negative
to hell with yhu with d korona ana can ana kashe mutane kunyi shiru kun kasa cewa komai allah wadai da wanna mulki naku 	negative
funny wai ya ciji bargo this one weaken me wlh wato sai dai kaji ana cewa el~muaz ya ciji bargo 	negative
ziyara  da zuwa motsa jiki 	positive
aww dama yayi karatu	neutral
ita ghana must go din dai da take yagewa 	neutral
oga muna ruwa wallahi	negative
allah yataimakeku nigerian    police	positive
inada tambaya wai miyasa bbc hausa batasa lbr niger 	neutral
wata sabuwar inji ƴan caca anya wnn gwabanan lfy yake kuwa	neutral
duka ya yanke ko ya rage saura	neutral
yaushe za su yi min makeup ni ma	neutral
tsiyar nasara sai xashi gida	neutral
akwai messi kuwa a wasan 	neutral
omo come see hausa oo wannan sai kace kune tsatson hausawa	neutral
yauwa maxa sun fara ramawa	neutral
masha allah allah ya qara daukaka 	positive
walahi mahmud yayi allah ya kara basira	positive
breaking  president buhari honours late abiola  declares june 12 democracy day hakama yayi daidai	positive
se dai da kuka tsunduma 	neutral
kwal uba yasin a dinga kashe kwaratan nan	neutral
may allah bless you mbuhari	positive
idan zaka fadi fadi gaskiya komai taka ja maka kabiya allah yana tare da masu gaskiyah	positive
  sauran arsenal itama tayi koyi da bayern munich	neutral
dani da da da da my mom da kuma sweety na 	neutral
what a lucky man hazbunallahu wani imal wakil allah ka lamince mana irin wannan sa ar 	positive
ya akai yasani an hada da na unguwar mu ojoo 	neutral
ai naga uwa su gomane 10 har buharin 11	neutral
innalillahi wainna ilaihi rajiun  allah ya jikansa da rahama allah ya baiwa alummar musulmi haqurin rashin dattijon arziki	positive
slm haj ali barka da sallah  allah maimaita mana but pls here is an observation na ga ka rubuta sunanka da kananan bakake baki daya at least the first alphabets have to be capitalized thanks for the time 	positive
innalillahi  allah ya kawo mana karshen abun	positive
mutun bai gama aikin shiba yaje yana yiin n wani 	negative
na haqura da karatun zan nema mata inyi aure thats it 	neutral
happy birthday rahama cheers 	positive
nabi barbaric dagudu ba takalmi sai yanxu kuka gani shegiya 	negative
wai rayuwar nan takoma cewa musulinci daban akin musulmin daban i mean both daga talakawan zuwa masu shugabancin wani shirman ma hankali baya dauka hmmmm wai kishi kuma wai tabun hankali  to muyi mekenan da mahaukatan cikin mu da suke yawo	negative
shadanin yaron nan zai kwace twitter	negative
allah ubangiji yaqara tsare gaba dan girman salati  u are my best actress rahama 	positive
ai tunda firauna ya zama dan africa to tabbas yana da jikoki a nigeria 	negative
allahu akkubar ai bazasu musaltuba 	neutral
pls kada ka haddasa bakin ciki a zuciyar dan naga taketakenka kenan but any way allah ya karawa rayuwa albarka da basira	positive
harda kannywood sai an daina shooting films	neutral
ikon allah masu comment naga duk arna  koda yake bari de nayi 	neutral
 tab din lallai fa akwai mastalla wlh what increase the price of brd hey wahala the oooh for poor man	negative
gaskiya ne malam  allah ya kara daukaka	positive
amin ya allah  allah ka yaye mana balain nan	positive
hahaha u are still a learnerki komai ba komai wannan gurin jindadi ne ya kamata ki jidadi ramatu	positive
allah save our fatherland from nemesis	neutral
wallahi kina  mutuniyarnan i hope to meet you 1 day saboda ina masifar sonki	positive
ansace karfe 11 na dare amma kuma wai da uniform ajikinsu kai ana shegiya a kasarnan	negative
ahh half zan yarda an rage hanya ai 	neutral
sai oga buhari sai alhaji buhari sai janar buhari sai dodar buhari	positive
youre right fa abin ba dadi gaskiya imagine having the headache of defending her on ig but ko reply na gaisuwa batayi 	negative
ni gani nai ma kamar an masa round	neutral
amma harda wiwi amma dan zata fi aiki 	negative
raayoyinku muke so ayau	neutral
toh allah ya rufa asiri haka kuma abun yake kasancewa  dame kuma zaaji fama da yadda zasuyi ko aikata zunubi	positive
amin ya allah ni kam bazan manta ba sai dai allah yasa wanda zan bawa rabon twitter family ba gidan kawu tsalha zai kai ba ll may allah accept our ibada amen	positive
alaramma harda tweet dinka 	neutral
a fita kuma da allah ya isaba to ko ragema hanya sukayi to akarshe dai ko rankwashinkane sai anyi 	negative
labari next season 	neutral
kunyi protest akan kisan da ake yi ne	negative
